suburb_ssc,suburb,suburb_id,Males - Total (no.),Females - Total (no.),Persons - Total (no.),Total population aged 15 years and over (no.),Median Household Weekly Income,Weekly median advertised rent,Non-School Qualifications (no.),Postgraduate Degree (no.),Graduate Diploma/Graduate Certificate (no.),Bachelor Degree (no.),Advanced Diploma/Diploma (no.),Certificate (no.),Labour Force (no.),Employed (no.),Unemployed (no.)
SSC10002,Abbotsbury,1,2076,2177,4253,3502,2171,575,282,95,32,497,363,715,2401,2297,104
SSC10003,Abbotsford,2,2542,2838,5380,4538,2006,885,513,398,124,1011,444,613,2756,2660,96
SSC10004,Abercrombie,3,535,579,1114,829,2006,0,45,30,15,139,77,235,594,573,21
SSC10006,Aberdare,4,1205,1262,2467,1942,998,0,208,7,8,70,119,525,1081,943,138
SSC10007,Aberdeen,5,1048,1036,2084,1631,1328,0,216,9,10,59,72,449,972,906,66
SSC10009,Aberglasslyn,6,2624,2781,5405,3961,1897,0,246,68,51,352,389,1261,2868,2695,173
SSC10010,Abermain,7,1162,1177,2339,1868,1185,350,187,7,11,89,103,530,1055,962,93
SSC10011,Abernethy,8,184,168,352,261,1575,0,74,0,0,8,20,85,130,121,9
SSC10013,Acacia Creek,9,17,22,39,33,762,0,0,0,0,0,6,3,21,16,5
SSC10014,Acacia Gardens,10,1898,1899,3797,2899,2378,523,174,230,53,650,299,503,2182,2074,108
SSC10015,Adaminaby,11,159,142,301,262,783,0,32,3,0,14,25,69,142,136,6
SSC10016,Adamstown,12,2918,3130,6048,4924,1404,450,314,220,102,845,466,1091,3325,3107,218
SSC10017,Adamstown Heights,13,2656,2642,5298,4193,1770,0,252,243,106,880,451,876,2660,2521,139
SSC10018,Adelong,14,475,467,942,764,1018,0,89,5,3,38,51,211,406,376,30
SSC10021,Agnes Banks,15,472,440,912,693,1910,0,61,15,6,57,54,189,480,463,17
SSC10022,Airds,16,1333,1591,2924,2140,677,0,368,8,0,28,96,319,706,525,181
SSC10025,Albion Park,17,6426,6893,13319,10363,1678,490,881,160,118,802,922,3095,6733,6347,386
SSC10026,Albion Park Rail,18,3372,3540,6912,5632,1198,440,743,47,39,293,415,1633,3134,2906,228
SSC10027,Albury,19,2335,2470,4805,4052,1372,350,545,226,128,767,406,703,2425,2288,137
SSC10028,Aldavilla,20,840,392,1232,1135,1125,0,594,3,0,44,39,190,327,311,16
SSC10029,Alectown,21,84,82,166,146,1312,0,15,0,0,14,19,20,85,82,3
SSC10030,Alexandria,22,4214,4054,8268,7389,2421,800,749,966,267,2492,707,727,5874,5670,204
SSC10031,Alfords Point,23,1524,1585,3109,2587,2622,750,189,118,56,451,290,524,1862,1792,70
SSC10034,Alison,24,44,45,89,80,2083,0,18,0,0,3,0,19,42,39,3
SSC10036,Allambie Heights,25,3404,3605,7009,5445,2229,940,495,322,137,1098,612,992,3496,3385,111
SSC10038,Allawah,26,2857,2852,5709,4850,1494,605,429,478,62,1095,535,534,3183,2936,247
SSC10041,Allworth,27,94,71,165,128,1050,0,21,0,0,5,5,44,72,67,5
SSC10044,Alpine,28,64,70,134,104,2200,0,13,7,3,23,12,17,66,66,0
SSC10046,Alstonville,29,2613,3122,5735,4762,1069,0,474,141,110,678,489,1036,2357,2217,140
SSC10049,Ambarvale,30,3598,3782,7380,5656,1287,0,682,82,39,374,433,1292,3238,2925,313
SSC10058,Anglers Reach,31,46,45,91,86,959,0,33,3,0,8,4,19,23,23,0
SSC10059,Angourie,32,102,118,220,191,1347,0,28,12,4,49,21,29,108,103,5
SSC10060,Anna Bay,33,1857,1983,3840,3249,1065,450,481,28,38,221,272,877,1643,1525,118
SSC10061,Annandale,34,4543,4911,9454,7888,2337,810,792,1155,293,2465,652,726,5603,5363,240
SSC10062,Annangrove,35,724,669,1393,1152,2484,0,85,43,15,158,122,287,793,779,14
SSC10063,Appin,36,1345,1285,2630,1961,2104,430,150,31,28,183,184,615,1403,1355,48
SSC10064,Apple Tree Flat,37,19,24,43,32,1374,0,11,0,0,4,0,10,13,13,0
SSC10069,Arakoon,38,220,197,417,384,1075,0,35,9,3,45,61,109,186,172,14
SSC10072,Arcadia,39,698,685,1383,1113,2433,0,78,62,29,185,129,239,753,728,25
SSC10073,Arcadia Vale,40,700,679,1379,1114,1366,0,90,26,11,89,109,352,661,613,48
SSC10076,Ardlethan,41,261,254,515,456,769,0,83,0,0,26,24,87,178,163,15
SSC10078,Argenton,42,679,671,1350,1113,1002,0,126,5,3,52,60,269,563,495,68
SSC10081,Ariah Park,43,248,242,490,385,907,0,45,0,4,37,28,87,191,187,4
SSC10084,Armatree,44,76,77,153,110,1228,0,20,0,0,12,10,22,75,67,8
SSC10085,Armidale,45,11142,12209,23351,19220,1201,340,2223,1607,517,2830,1391,3314,10512,9636,876
SSC10086,Arncliffe,46,5307,5283,10590,8903,1657,625,1106,656,125,1730,770,1054,5346,5011,335
SSC10087,Arndell Park,47,28,6,34,27,0,0,14,0,0,0,0,10,19,19,0
SSC10088,Arrawarra,48,253,268,521,491,682,0,105,3,3,32,34,118,100,91,9
SSC10089,Arrawarra Headland,49,279,276,555,460,1222,0,45,17,16,81,33,90,253,234,19
SSC10090,Artarmon,50,4654,4876,9530,7694,2183,983,662,1220,256,2518,694,546,5335,5058,277
SSC10093,Ashbury,51,1654,1675,3329,2667,2157,680,210,209,79,510,251,431,1706,1646,60
SSC10097,Ashcroft,52,1753,1827,3580,2687,887,380,570,19,10,109,119,366,1034,893,141
SSC10098,Ashfield,53,11773,12067,23840,20897,1632,600,2462,2399,474,5363,1901,1891,13151,12225,926
SSC10100,Ashley,54,191,176,367,257,1557,0,37,7,3,12,15,65,179,176,3
SSC10101,Ashmont,55,1810,2021,3831,2951,876,0,390,21,18,118,138,691,1485,1295,190
SSC10102,Ashtonfield,56,2288,2363,4651,3520,1844,0,264,125,70,434,384,903,2402,2275,127
SSC10103,Asquith,57,1621,1759,3380,2661,2029,580,180,242,67,601,329,448,1761,1675,86
SSC10106,Auburn,58,20570,16799,37369,30119,1240,470,4939,1751,229,4296,2259,2510,16113,14075,2038
SSC10108,Austinmer,59,1241,1317,2558,2043,2031,730,162,239,103,540,229,308,1311,1245,66
SSC10109,Austral,60,1523,1504,3027,2523,1353,530,511,31,5,150,143,484,1264,1207,57
SSC10111,Avalon Beach,61,4830,5078,9908,7937,2137,0,630,485,216,1690,1021,1393,5159,4977,182
SSC10114,Avoca Beach,62,2284,2303,4587,3578,1896,600,274,165,92,684,454,764,2373,2256,117
SSC10116,Avondale,63,809,844,1653,1353,1278,450,158,22,21,84,108,398,798,737,61
SSC10117,Avonside,64,56,59,115,83,2049,0,12,0,0,14,22,30,56,53,3
SSC10118,Awaba,65,202,197,399,311,1597,0,27,8,0,29,25,74,191,179,12
SSC10120,Baan Baa,66,91,70,161,132,1218,0,18,0,0,3,9,25,81,75,6
SSC10132,Badgerys Creek,67,111,109,220,173,1278,0,12,0,3,7,4,27,85,81,4
SSC10143,Balaclava,68,233,264,497,402,1213,0,65,19,3,31,33,115,236,232,4
SSC10145,Balcolyn,69,470,494,964,776,1153,0,67,21,11,91,84,206,409,384,25
SSC10153,Balgowlah,70,3827,4133,7960,6254,2261,1015,591,582,207,1797,717,781,4290,4152,138
SSC10154,Balgowlah Heights,71,1625,1720,3345,2438,3726,0,171,311,92,797,236,182,1592,1532,60
SSC10155,Balgownie,72,2658,2867,5525,4528,1558,500,393,235,114,679,472,980,2584,2474,110
SSC10162,Ballina,73,3956,4698,8654,7640,819,500,1378,121,78,615,593,1606,3079,2854,225
SSC10164,Balmain,74,5019,5433,10452,8660,2550,865,1026,1317,351,2628,784,716,5858,5634,224
SSC10165,Balmain East,75,952,986,1938,1619,2485,0,189,263,54,516,142,124,1041,994,47
SSC10173,Bangalee,76,323,330,653,564,1916,0,51,18,17,77,66,141,343,331,12
SSC10174,Bangalow,77,960,1057,2017,1587,1401,675,197,83,37,327,186,251,1007,976,31
SSC10177,Bangor,78,2764,2804,5568,4555,2289,0,299,206,106,749,508,1063,3061,2957,104
SSC10178,Banksia,79,1674,1709,3383,2795,1685,600,327,149,38,451,246,400,1711,1608,103
SSC10179,Banksmeadow,80,10,6,16,15,0,0,3,0,0,3,0,4,15,15,0
SSC10180,Bankstown,81,15831,16283,32114,25047,1120,500,3747,1200,198,3618,2122,2870,12884,11490,1394
SSC10185,Banora Point,82,7542,8628,16170,13725,1080,570,1467,189,166,1113,1216,3231,6687,6266,421
SSC10187,Bar Beach,83,676,576,1252,1095,1719,0,137,92,24,294,86,136,688,653,35
SSC10190,Baradine,84,385,374,759,629,771,0,72,6,3,31,29,132,262,236,26
SSC10191,Barangaroo,85,104,80,184,170,3661,0,75,20,3,37,5,11,78,78,0
SSC10193,Barden Ridge,86,2135,2196,4331,3489,2772,0,201,129,64,528,411,806,2609,2520,89
SSC10194,Bardia,87,807,795,1602,1157,2187,0,96,119,17,276,107,184,878,820,58
SSC10195,Bardwell Park,88,1100,1135,2235,1828,1992,720,139,114,39,338,236,285,1192,1140,52
SSC10196,Bardwell Valley,89,1111,1211,2322,1891,1684,0,178,90,39,318,212,267,1132,1062,70
SSC10197,Barellan,90,292,246,538,427,1154,0,72,0,7,18,22,87,227,222,5
SSC10198,Bargo,91,2208,2184,4392,3477,1485,450,323,49,30,217,312,1023,2126,2023,103
SSC10199,Barham,92,739,779,1518,1312,835,0,211,10,11,86,92,242,601,580,21
SSC10202,Barmedman,93,230,226,456,357,808,0,60,0,3,22,29,67,152,133,19
SSC10204,Barnsley,94,875,874,1749,1388,1402,0,91,13,10,49,102,481,924,848,76
SSC10206,Barraba,95,682,726,1408,1218,737,0,205,5,11,65,54,237,460,415,45
SSC10207,Barrack Heights,96,2871,3034,5905,4771,1088,0,543,47,41,251,365,1222,2509,2307,202
SSC10208,Barrack Point,97,347,340,687,558,1342,0,79,15,9,64,58,152,311,300,11
SSC10213,Barrengarry,98,109,87,196,159,1375,0,33,5,5,19,13,30,82,82,0
SSC10218,Barry,99,83,78,161,132,1281,0,15,0,6,10,11,36,75,72,3
SSC10223,Basin View,100,741,811,1552,1263,970,0,159,14,11,77,113,347,611,568,43
SSC10224,Bass Hill,101,4469,4603,9072,7009,1225,560,776,177,56,674,585,1171,3629,3291,338
SSC10227,Bateau Bay,102,5693,6453,12146,9970,1245,455,1125,189,114,1023,864,2414,5442,5133,309
SSC10228,Batehaven,103,823,953,1776,1550,901,0,267,23,17,113,108,349,661,588,73
SSC10229,Batemans Bay,104,759,768,1527,1332,703,375,269,7,16,54,71,270,479,415,64
SSC10231,Bathurst,105,3409,3517,6926,6035,1029,340,752,261,123,859,464,1158,3437,3164,273
SSC10232,Batlow,106,666,646,1312,1119,928,0,168,7,10,90,80,233,579,551,28
SSC10233,Baulkham Hills,107,18139,18917,37056,29040,2107,560,1978,2902,648,6488,3263,4564,19449,18490,959
SSC10235,Bawley Point,108,342,354,696,592,1025,0,45,24,21,79,57,168,275,254,21
SSC10237,Bayview,109,1659,1957,3616,3132,1476,1100,415,192,48,589,384,453,1492,1439,53
SSC10238,Beacon Hill,110,3733,3731,7464,5880,2369,875,473,336,120,1161,670,1099,4006,3861,145
SSC10239,Beaconsfield,111,516,473,989,860,2330,890,72,85,30,250,93,96,678,666,12
SSC10243,Beaumont Hills,112,4494,4546,9040,6735,2787,620,414,511,139,1585,796,986,4934,4725,209
SSC10244,Beckom,113,71,53,124,93,1375,0,17,0,3,8,8,13,61,57,4
SSC10248,Beechwood,114,292,317,609,480,1093,0,43,0,6,41,34,131,268,245,23
SSC10249,Beecroft,115,4451,4942,9393,7583,2598,0,617,1090,238,2150,731,710,4719,4530,189
SSC10251,Beelbangera,116,206,204,410,335,1368,0,45,3,0,20,17,89,212,204,8
SSC10253,Bega,117,2245,2419,4664,3750,974,350,489,57,45,300,259,842,1975,1854,121
SSC10256,Belbora,118,61,62,123,113,949,0,24,3,0,10,12,19,53,50,3
SSC10257,Belfield,119,3054,3262,6316,5054,1440,550,508,192,63,761,485,756,2914,2766,148
SSC10258,Belford,120,85,92,177,135,2416,0,17,3,0,13,13,43,97,93,4
SSC10261,Belimbla Park,121,285,293,578,463,1980,0,40,14,5,35,44,149,309,302,7
SSC10262,Bell,122,22,21,43,44,899,0,0,0,0,5,5,12,16,13,3
SSC10263,Bella Vista,123,3869,3963,7832,6421,2942,740,434,674,141,1671,680,739,4480,4223,257
SSC10264,Bellambi,124,1909,2039,3948,3250,924,440,365,65,32,255,276,751,1636,1464,172
SSC10266,Bellata,125,183,167,350,260,1218,0,33,3,0,20,15,36,164,154,10
SSC10267,Bellawongarah,126,68,61,129,117,2166,0,21,10,4,23,19,21,50,50,0
SSC10268,Bellbird,127,993,1039,2032,1577,1175,0,181,13,11,69,106,493,876,804,72
SSC10269,Bellbird Heights,128,364,420,784,629,1368,0,46,3,3,48,55,189,368,341,27
SSC10270,Bellbrook,129,140,130,270,225,740,0,25,4,3,22,18,38,84,76,8
SSC10271,Bellevue Hill,130,5222,5496,10718,8782,2892,1888,967,1097,211,2926,744,615,5662,5466,196
SSC10273,Bellingen,131,1750,2030,3780,2930,1032,420,315,128,84,499,324,599,1543,1437,106
SSC10276,Belmont,132,3453,3662,7115,5994,1040,400,635,128,64,598,499,1505,3094,2852,242
SSC10277,Belmont North,133,3128,3210,6338,5081,1409,0,518,90,64,479,428,1436,3008,2784,224
SSC10278,Belmont South,134,512,544,1056,898,1026,385,81,9,8,51,59,230,484,427,57
SSC10279,Belmore,135,6337,6386,12723,10467,1192,550,1436,457,96,1370,896,1431,5700,5220,480
SSC10283,Belrose,136,4225,4554,8779,7076,2117,998,730,386,155,1340,877,1151,4075,3917,158
SSC10284,Bemboka,137,292,285,577,478,870,0,64,15,12,46,41,104,241,226,15
SSC10285,Ben Bullen,138,58,48,106,82,2041,0,25,0,0,3,3,26,42,42,0
SSC10287,Benandarah,139,94,68,162,145,739,0,42,0,7,6,0,31,48,45,3
SSC10288,Bendalong,140,51,38,89,82,825,0,7,5,0,6,7,26,36,31,5
SSC10289,Bendemeer,141,248,246,494,416,905,0,58,10,10,30,22,88,233,219,14
SSC10290,Bendick Murrell,142,83,73,156,128,924,0,21,3,0,4,12,29,68,65,3
SSC10293,Benerembah,143,66,68,134,86,1218,0,19,0,0,14,4,12,56,53,3
SSC10295,Bennetts Green,144,9,7,16,9,749,0,0,0,0,0,0,3,3,3,0
SSC10297,Bensville,145,1267,1279,2546,1991,1960,0,113,57,50,266,233,538,1386,1326,60
SSC10299,Berala,146,4689,4361,9050,7445,1319,450,930,278,59,1170,587,853,4207,3780,427
SSC10300,Berambing,147,54,50,104,82,1812,0,10,4,3,17,5,23,58,50,8
SSC10301,Beresfield,148,1616,1567,3183,2625,1032,360,244,27,13,117,150,696,1395,1258,137
SSC10302,Bergalia,149,88,85,173,137,1395,0,14,5,3,20,18,33,79,79,0
SSC10303,Berkeley,150,3706,3900,7606,6161,1059,428,741,88,39,344,425,1427,3127,2843,284
SSC10304,Berkeley Vale,151,4008,4341,8349,6635,1397,0,550,88,80,533,617,1909,4186,3916,270
SSC10305,Berkshire Park,152,1337,796,2133,1901,1716,0,1084,11,0,44,61,254,582,557,25
SSC10307,Bermagui,153,744,788,1532,1312,843,0,174,42,31,129,112,328,546,513,33
SSC10308,Berowra,154,2353,2365,4718,3694,2355,628,215,258,102,782,428,724,2642,2537,105
SSC10309,Berowra Creek,155,8,8,16,15,0,0,0,0,0,3,0,4,5,5,0
SSC10310,Berowra Heights,156,2593,2666,5259,4033,2138,0,234,255,118,792,507,894,2860,2764,96
SSC10311,Berowra Waters,157,62,60,122,109,749,0,61,0,0,6,10,11,19,19,0
SSC10313,Berrara,158,144,153,297,254,891,0,26,3,4,18,29,88,118,115,3
SSC10316,Berridale,159,621,574,1195,965,1105,393,109,24,23,73,71,308,592,579,13
SSC10318,Berrigan,160,632,629,1261,1069,880,0,209,7,10,65,71,227,523,489,34
SSC10319,Berrilee,161,121,111,232,187,2143,0,10,10,6,29,27,37,121,114,7
SSC10320,Berrima,162,327,347,674,565,1548,0,75,46,10,108,50,113,319,309,10
SSC10322,Berry,163,1212,1452,2664,2273,1252,530,297,106,52,354,268,434,1032,998,34
SSC10328,Bethungra,164,85,78,163,147,725,0,18,0,0,14,15,35,82,78,4
SSC10330,Beverley Park,165,1202,1197,2399,1923,1819,0,181,96,32,354,204,296,1198,1137,61
SSC10331,Beverly Hills,166,4892,5257,10149,8460,1549,598,826,481,117,1488,768,1180,4884,4551,333
SSC10332,Bewong,167,41,45,86,69,1187,0,10,0,0,0,7,20,37,37,0
SSC10334,Bexley,168,9632,10099,19731,16153,1556,600,2490,860,177,2494,1464,2189,9102,8550,552
SSC10335,Bexley North,169,1994,2104,4098,3352,1570,0,350,168,45,618,328,454,1904,1794,110
SSC10337,Bibbenluke,170,46,44,90,77,1156,0,15,0,0,7,7,10,41,38,3
SSC10340,Bidwill,171,1996,2287,4283,3119,798,330,568,26,5,90,133,433,1212,961,251
SSC10346,Bigga,172,132,114,246,214,866,0,54,5,0,13,10,31,93,89,4
SSC10347,Bilambil,173,212,198,410,338,1346,0,42,10,3,32,25,89,201,182,19
SSC10348,Bilambil Heights,174,1655,1707,3362,2728,1295,0,292,62,43,307,278,713,1603,1501,102
SSC10349,Bilbul,175,292,266,558,416,1442,0,57,3,0,20,22,119,301,292,9
SSC10350,Bilgola Beach,176,120,128,248,203,3277,0,15,26,4,52,34,23,123,119,4
SSC10351,Bilgola Plateau,177,1751,1768,3519,2734,2399,0,169,204,89,626,377,495,1853,1796,57
SSC10354,Billimari,178,76,80,156,126,833,0,31,3,3,16,7,17,56,53,3
SSC10355,Billinudgel,179,111,103,214,184,955,0,28,3,3,19,16,31,98,93,5
SSC10358,Bilpin,180,324,342,666,547,1455,0,74,15,6,49,50,161,339,318,21
SSC10362,Binalong,181,281,264,545,433,1104,0,40,14,12,46,32,91,250,241,9
SSC10365,Bingara,182,680,747,1427,1250,760,0,225,5,6,66,71,241,469,439,30
SSC10369,Biniguy,183,77,71,148,117,1292,0,23,0,0,17,0,18,66,66,0
SSC10372,Binnaway,184,323,287,610,538,710,0,94,3,3,12,28,70,184,155,29
SSC10373,Binya,185,76,61,137,92,1449,0,4,0,3,18,8,12,79,76,3
SSC10374,Birchgrove,186,1548,1756,3304,2668,3225,0,262,462,105,907,230,176,1818,1741,77
SSC10377,Birmingham Gardens,187,1261,1114,2375,2028,1061,0,191,110,17,266,134,343,1036,878,158
SSC10379,Birrong,188,1526,1583,3109,2494,1373,490,305,76,25,311,208,350,1342,1218,124
SSC10384,Black Head,189,386,466,852,783,990,0,86,22,20,106,93,193,280,259,21
SSC10385,Black Hill,190,279,289,568,453,2166,0,41,23,14,70,60,108,263,255,8
SSC10389,Black Springs,191,111,108,219,195,1312,0,33,0,0,12,6,38,89,84,5
SSC10390,Blackalls Park,192,1325,1430,2755,2260,1139,0,186,33,37,177,188,636,1258,1163,95
SSC10391,Blackbutt,193,1570,1732,3302,2730,1373,0,222,63,26,245,238,739,1678,1565,113
SSC10392,Blackett,194,1657,1789,3446,2549,1018,0,435,17,10,98,104,427,1150,1010,140
SSC10393,Blackheath,195,2107,2291,4398,3713,1077,400,370,290,116,707,435,692,1937,1839,98
SSC10394,Blackmans Flat,196,10,18,28,22,1624,0,5,0,0,3,0,10,8,8,0
SSC10395,Blackmans Point,197,87,80,167,155,900,0,27,0,5,11,6,41,59,56,3
SSC10396,Blacksmiths,198,936,911,1847,1568,988,430,149,19,13,126,116,411,815,747,68
SSC10397,Blacktown,199,23761,23411,47172,37515,1459,395,4028,2310,378,5660,3419,5918,22792,20937,1855
SSC10399,Blackwall,200,905,989,1894,1587,1188,375,191,31,30,140,149,378,826,763,63
SSC10400,Blair Athol,201,1444,1433,2877,2237,2206,0,147,91,24,429,236,375,1573,1464,109
SSC10401,Blairmount,202,217,206,423,318,1850,0,37,6,5,38,32,53,202,191,11
SSC10402,Blakebrook,203,71,75,146,122,1083,0,18,4,0,6,4,32,73,69,4
SSC10403,Blakehurst,204,3046,3179,6225,5052,2080,750,421,296,77,1093,540,685,3005,2871,134
SSC10407,Blaxland,205,3606,3843,7449,5944,1814,450,401,398,182,1063,704,1339,3837,3688,149
SSC10410,Blayney,206,1676,1697,3373,2689,1089,295,367,24,26,168,161,674,1531,1410,121
SSC10411,Bligh Park,207,3075,3287,6362,4846,1763,425,275,73,57,365,452,1469,3573,3425,148
SSC10412,Blighty,208,78,68,146,105,955,0,12,0,0,7,9,24,77,77,0
SSC10414,Blue Bay,209,486,541,1027,894,1141,0,111,32,11,89,84,196,473,448,25
SSC10415,Blue Haven,210,3058,3321,6379,4815,1331,393,443,22,29,213,361,1357,2947,2682,265
SSC10416,Blue Knob,211,122,105,227,194,604,0,45,8,5,38,10,37,78,63,15
SSC10420,Blueys Beach,212,100,87,187,156,819,0,23,8,0,19,17,41,67,64,3
SSC10421,Boambee,213,854,810,1664,1362,1557,385,141,41,34,232,131,302,844,800,44
SSC10422,Boambee East,214,2527,2718,5245,4191,1166,0,339,51,58,399,386,1145,2455,2280,175
SSC10425,Boat Harbour,215,478,486,964,763,1481,0,58,26,18,114,92,211,457,440,17
SSC10429,Bobs Farm,216,233,215,448,386,1286,0,53,6,3,35,25,121,221,207,14
SSC10434,Bodalla,217,373,361,734,632,957,0,55,10,7,46,53,180,344,315,29
SSC10438,Bogan Gate,218,167,125,292,223,816,0,51,0,0,10,12,37,103,94,9
SSC10439,Bogangar,219,1531,1535,3066,2438,1280,0,244,58,60,315,206,633,1514,1414,100
SSC10441,Boggabilla,220,487,501,988,733,919,0,152,3,7,44,31,88,300,249,51
SSC10442,Boggabri,221,569,557,1126,914,1162,0,164,3,3,44,44,190,471,439,32
SSC10444,Bohena Creek,222,85,83,168,141,1642,0,29,0,3,7,7,34,96,92,4
SSC10447,Bolivia,223,35,32,67,57,900,0,3,0,0,8,6,13,30,30,0
SSC10449,Bolton Point,224,1010,1115,2125,1726,1009,385,260,27,24,145,129,403,794,689,105
SSC10450,Bolwarra,225,486,501,987,804,1706,0,59,39,12,147,74,204,506,481,25
SSC10451,Bolwarra Heights,226,1481,1493,2974,2246,2147,0,146,79,56,354,274,559,1515,1453,62
SSC10453,Bomaderry,227,3255,3404,6659,5537,927,398,742,81,66,414,468,1412,2602,2407,195
SSC10455,Bombala,228,697,685,1382,1132,1090,280,144,9,10,69,67,261,650,628,22
SSC10457,Bombira,229,176,171,347,272,2166,0,31,9,6,58,29,56,176,173,3
SSC10458,Bombo,230,55,52,107,101,1375,0,19,4,0,9,13,26,52,49,3
SSC10461,Bomen,231,20,8,28,20,2166,0,0,0,4,0,5,7,15,15,0
SSC10463,Bonalbo,232,191,184,375,319,725,0,59,0,9,20,9,70,111,98,13
SSC10464,Bondi,233,4958,5096,10054,8816,2175,1150,1383,922,196,2720,879,849,6105,5859,246
SSC10465,Bondi Beach,234,5831,5824,11655,10369,2253,1180,1877,1162,256,3311,890,844,7225,6955,270
SSC10467,Bondi Junction,235,4530,4907,9437,8262,2026,946,1431,927,200,2415,777,678,5269,5043,226
SSC10468,Bonnells Bay,236,1758,1822,3580,2932,1210,390,265,74,40,263,318,764,1605,1478,127
SSC10469,Bonnet Bay,237,1141,1124,2265,1840,2706,0,107,117,51,390,253,354,1255,1227,28
SSC10470,Bonny Hills,238,1461,1514,2975,2438,1264,430,227,63,43,296,236,690,1304,1239,65
SSC10471,Bonnyrigg,239,4174,4491,8665,6980,1196,478,1083,95,22,601,482,881,3439,3036,403
SSC10472,Bonnyrigg Heights,240,3623,3678,7301,5899,1679,480,707,90,43,635,497,910,3425,3158,267
SSC10474,Bonville,241,1291,1262,2553,2070,1453,0,179,32,37,265,193,560,1223,1154,69
SSC10477,Booker Bay,242,646,676,1322,1174,1002,470,154,21,13,113,99,268,509,477,32
SSC10482,Boolaroo,243,514,524,1038,897,1187,448,71,11,8,59,67,245,542,495,47
SSC10487,Boomerang Beach,244,158,135,293,240,1114,0,34,5,9,27,17,64,133,128,5
SSC10495,Booragul,245,586,694,1280,1060,932,0,92,9,7,70,72,269,490,440,50
SSC10496,Booral,246,202,199,401,333,1406,0,38,6,3,23,21,94,202,191,11
SSC10501,Boorooma,247,417,447,864,658,2078,0,42,29,20,147,54,131,489,482,7
SSC10503,Boorowa,248,834,807,1641,1371,973,0,189,21,9,102,98,299,734,699,35
SSC10512,Boree Creek,249,99,101,200,157,1034,0,15,0,0,9,10,38,89,86,3
SSC10513,Borenore,250,247,214,461,364,1983,0,47,20,11,61,33,84,248,240,8
SSC10515,Bossley Park,251,7220,7361,14581,11995,1511,480,1437,214,71,1223,964,1957,6231,5776,455
SSC10516,Bostobrick,252,75,65,140,111,1024,0,10,0,0,13,9,32,62,55,7
SSC10517,Botany,253,5408,5414,10822,8584,2028,780,1020,510,131,1385,892,1532,5862,5633,229
SSC10520,Bouddi,254,4,3,7,4,0,0,3,0,0,0,0,0,3,3,0
SSC10523,Bourkelands,255,1371,1481,2852,2171,1912,0,154,68,50,306,237,562,1620,1574,46
SSC10524,Bournda,256,82,70,152,120,1104,0,29,4,0,15,8,37,61,61,0
SSC10526,Bow Bowing,257,805,803,1608,1265,1797,0,83,41,3,174,138,246,926,871,55
SSC10528,Bowen Mountain,258,793,784,1577,1204,1724,0,98,45,27,157,135,336,854,812,42
SSC10529,Bowenfels,259,988,1062,2050,1607,787,0,297,12,5,58,72,345,632,534,98
SSC10535,Bowning,260,288,279,567,471,1389,0,61,14,8,44,49,94,290,279,11
SSC10536,Bowral,261,4765,5573,10338,8690,1299,550,946,515,250,1424,1033,1594,4241,4062,179
SSC10537,Bowraville,262,564,557,1121,890,742,0,130,6,9,44,51,204,383,342,41
SSC10539,Box Hill,263,460,442,902,751,1760,0,59,16,3,78,63,190,436,424,12
SSC10543,Bradbury,264,4308,4495,8803,6893,1373,380,685,150,63,577,572,1668,4053,3718,335
SSC10545,Braemar,265,224,220,444,342,1708,0,34,19,3,43,28,97,242,234,8
SSC10547,Braidwood,266,792,863,1655,1336,1091,400,213,67,28,184,103,264,721,685,36
SSC10548,Brandy Hill,267,326,345,671,574,2028,0,55,14,11,77,56,146,378,370,8
SSC10549,Branxton,268,986,1003,1989,1557,1678,350,148,23,20,144,131,443,1003,950,53
SSC10555,Breadalbane,269,49,50,99,72,1624,0,13,3,0,18,3,12,46,46,0
SSC10557,Breakfast Point,270,1947,2240,4187,3602,2175,0,332,399,97,923,426,457,2355,2252,103
SSC10559,Bredbo,271,175,174,349,281,1681,0,50,11,3,26,24,65,189,175,14
SSC10564,Brewongle,272,62,57,119,104,1281,0,20,0,3,8,3,31,54,54,0
SSC10566,Bribbaree,273,75,64,139,118,714,0,19,0,0,3,4,26,65,60,5
SSC10567,Bridgman,274,105,96,201,152,2062,0,12,3,3,10,16,58,110,106,4
SSC10570,Brightwaters,275,446,455,901,749,1333,0,60,21,14,71,89,220,410,380,30
SSC10575,Bringelly,276,1289,1215,2504,2044,1700,0,229,21,20,167,134,511,1262,1197,65
SSC10578,Broadmeadow,277,801,798,1599,1311,1288,415,108,65,30,252,112,268,902,824,78
SSC10579,Broadwater,278,61,61,122,91,1275,0,11,0,3,5,6,28,47,47,0
SSC10583,Brocklehurst,279,190,172,362,280,1196,0,36,3,4,21,22,70,168,161,7
SSC10587,Brogans Creek,280,5,3,8,10,0,0,0,0,0,0,0,4,0,0,0
SSC10589,Brogo,281,264,239,503,435,977,0,48,14,12,56,38,111,236,217,19
SSC10590,Broke,282,300,282,582,438,1662,0,89,9,4,36,25,108,229,217,12
SSC10591,Broken Head,283,137,139,276,229,1395,0,24,17,4,52,24,46,132,128,4
SSC10594,Bronte,284,3333,3397,6730,5386,2671,1335,584,718,152,1687,484,557,3765,3631,134
SSC10599,Brooklyn,285,381,343,724,632,1631,550,61,42,10,101,61,132,412,396,16
SSC10601,Brookvale,286,1571,1588,3159,2699,1822,790,242,160,47,572,305,504,1959,1884,75
SSC10608,Broulee,287,803,914,1717,1438,1002,450,178,46,45,208,130,327,662,635,27
SSC10609,Brownlow Hill,288,187,234,421,338,2299,0,22,46,8,49,24,67,190,179,11
SSC10612,Brownsville,289,288,244,532,471,875,0,41,4,6,25,25,124,232,204,28
SSC10613,Brucedale,290,86,87,173,144,2200,0,13,8,3,25,7,46,103,103,0
SSC10617,Brundee,291,26,25,51,37,1187,0,7,0,0,3,0,17,28,28,0
SSC10621,Brunswick Heads,292,821,924,1745,1504,844,650,221,52,32,200,148,319,743,684,59
SSC10628,Buchanan,293,95,101,196,165,1812,0,27,6,4,15,8,40,99,93,6
SSC10629,Buckajo,294,157,140,297,248,1363,0,35,3,3,23,17,73,172,161,11
SSC10637,Buddabadah,295,25,29,54,40,2416,0,4,0,0,4,7,8,31,31,0
SSC10641,Budgee Budgee,296,94,102,196,158,1687,0,18,0,0,19,15,55,100,97,3
SSC10642,Budgewoi,297,1669,1691,3360,2789,1029,350,323,35,36,173,216,777,1453,1333,120
SSC10645,Buff Point,298,1747,1761,3508,2863,1104,390,330,25,15,166,214,811,1475,1349,126
SSC10646,Bugaldie,299,74,69,143,121,664,0,20,0,0,12,7,25,57,53,4
SSC10649,Bulahdelah,300,732,693,1425,1234,780,350,175,13,15,60,64,262,548,504,44
SSC10651,Bulga,301,176,185,361,283,1553,0,49,9,0,32,19,60,162,152,10
SSC10656,Bullaburra,302,616,612,1228,995,1389,0,77,57,34,163,128,232,597,574,23
SSC10658,Bullarah,303,64,47,111,100,1424,0,28,0,0,10,7,10,71,71,0
SSC10662,Bulli,304,2970,3138,6108,4719,1896,593,377,325,141,763,501,1059,3070,2935,135
SSC10663,Bulliac,305,23,25,48,37,1125,0,6,0,0,3,3,3,21,21,0
SSC10666,Bumbaldry,306,56,47,103,92,966,0,18,0,0,5,10,22,43,37,6
SSC10669,Bundagen,307,73,59,132,114,478,0,17,5,0,26,12,19,53,46,7
SSC10670,Bundanoon,308,1283,1447,2730,2353,1107,0,266,120,65,362,273,522,1082,1037,45
SSC10671,Bundarra,309,333,341,674,556,773,0,91,6,8,30,42,122,248,224,24
SSC10672,Bundeena,310,921,996,1917,1579,1614,600,121,130,50,256,185,368,972,929,43
SSC10676,Bundook,311,56,44,100,85,732,0,13,0,0,4,0,28,39,32,7
SSC10682,Bungarribee,312,1346,1290,2636,1886,2560,0,114,281,38,567,184,174,1419,1354,65
SSC10684,Bungendore,313,2101,2083,4184,3194,2514,0,318,246,108,449,386,691,2319,2251,68
SSC10685,Bungonia,314,182,191,373,308,1025,0,45,12,0,24,19,69,175,157,18
SSC10687,Bungwahl,315,122,113,235,187,941,0,18,7,6,18,12,55,98,90,8
SSC10696,Buronga,316,617,597,1214,947,1149,0,140,10,12,81,96,223,570,531,39
SSC10700,Burraboi,317,30,32,62,49,1312,0,3,0,0,3,3,19,39,39,0
SSC10701,Burradoo,318,1248,1391,2639,2259,1733,0,257,157,61,476,290,321,952,918,34
SSC10705,Burraneer,319,1766,1825,3591,2881,2860,1125,225,167,67,622,352,474,1930,1888,42
SSC10708,Burrawang,320,177,186,363,293,1375,0,19,21,7,45,38,77,173,169,4
SSC10709,Burrell Creek,321,112,106,218,190,1031,0,26,7,3,15,20,47,102,98,4
SSC10710,Burren Junction,322,153,125,278,214,1014,0,29,0,3,18,10,43,128,124,4
SSC10712,Burrill Lake,323,728,738,1466,1228,864,0,137,18,12,85,104,329,549,523,26
SSC10713,Burringbar,324,409,441,850,707,1165,0,92,15,13,61,55,163,402,373,29
SSC10717,Burrundulla,325,69,74,143,113,1906,0,19,0,0,10,14,28,67,67,0
SSC10718,Burwood,326,7670,8359,16029,14462,1398,650,1565,1667,198,3568,1232,943,7982,7187,795
SSC10719,Burwood Heights,327,440,544,984,818,1863,0,116,62,9,166,58,101,460,438,22
SSC10720,Busby,328,2107,2179,4286,3212,1026,360,617,28,9,157,190,487,1371,1180,191
SSC10722,Bushells Ridge,329,4,7,11,18,724,0,3,0,0,0,0,3,4,4,0
SSC10723,Buttaba,330,558,537,1095,881,1435,0,54,25,10,105,85,259,512,480,32
SSC10724,Buttai,331,28,29,57,42,2249,0,0,3,0,10,5,12,36,36,0
SSC10726,Buxton,332,1024,1005,2029,1525,1787,410,131,20,13,86,135,490,1080,1024,56
SSC10727,Byabarra,333,160,169,329,262,1454,0,23,7,7,32,19,76,154,149,5
SSC10730,Bylong,334,8,9,17,23,1562,0,9,3,0,4,3,4,16,16,0
SSC10733,Byron Bay,335,2683,2841,5524,4841,1197,780,1121,182,98,857,438,788,2491,2352,139
SSC10735,Bywong,336,668,651,1319,1069,2450,0,103,104,49,214,105,182,720,703,17
SSC10736,Cabarita,337,960,1000,1960,1648,2559,1100,130,166,49,416,183,214,996,968,28
SSC10737,Cabarita Beach,338,48,53,101,81,1083,0,3,0,0,10,5,11,54,45,9
SSC10740,Cabramatta,339,10633,11152,21785,17880,968,400,3318,229,63,1454,1032,1665,8761,7447,1314
SSC10741,Cabramatta West,340,3516,3708,7224,5799,1189,400,924,69,20,468,319,637,2892,2542,350
SSC10742,Cabramurra,341,20,13,33,33,0,0,11,0,0,3,3,9,18,18,0
SSC10743,Caddens,342,726,754,1480,1154,2190,0,111,73,11,184,114,238,714,659,55
SSC10748,Calala,343,1956,1977,3933,3000,1520,0,249,75,69,337,319,760,1949,1874,75
SSC10750,Calderwood,344,100,77,177,140,1895,0,20,6,0,18,11,45,96,92,4
SSC10751,Caldwell,345,18,16,34,30,1042,0,0,0,0,6,0,5,21,18,3
SSC10755,Callaghan,346,593,734,1327,1326,0,0,67,9,3,49,41,91,665,460,205
SSC10757,Callala Bay,347,1100,1094,2194,1843,1024,370,160,31,26,152,187,505,894,825,69
SSC10758,Callala Beach,348,407,395,802,689,897,0,112,20,7,60,52,185,276,251,25
SSC10763,Cambewarra,349,119,119,238,202,1937,0,23,13,0,42,21,46,134,134,0
SSC10764,Cambewarra Village,350,594,601,1195,915,1875,0,65,34,36,150,110,225,625,605,20
SSC10767,Cambridge Gardens,351,986,1034,2020,1576,1766,0,122,31,15,108,126,479,1093,1038,55
SSC10768,Cambridge Park,352,3329,3397,6726,5316,1429,380,549,91,29,347,387,1317,3299,3085,214
SSC10770,Camden,353,1523,1709,3232,2656,1379,420,388,88,52,316,240,586,1561,1490,71
SSC10771,Camden Head,354,78,76,154,125,900,0,12,6,4,23,13,32,50,47,3
SSC10772,Camden Park,355,1062,1172,2234,1658,2776,0,92,64,29,245,217,395,1257,1233,24
SSC10773,Camden South,356,2224,2315,4539,3561,1812,0,202,123,64,469,379,980,2370,2288,82
SSC10775,Cameron Park,357,3891,4099,7990,5845,2103,510,465,190,77,694,550,1609,4252,4054,198
SSC10778,Cammeray,358,3283,3721,7004,5725,2361,1150,489,722,228,1995,611,514,4167,4021,146
SSC10780,Campbelltown,359,6131,6442,12573,10338,1206,380,1313,369,109,1121,849,1991,5662,5188,474
SSC10781,Camperdown,360,4996,5349,10345,9623,1796,750,1046,1259,270,2995,673,589,6438,5971,467
SSC10782,Campsie,361,12319,12219,24538,20799,1239,540,2569,1378,215,3622,1879,1924,12114,10986,1128
SSC10783,Campvale,362,25,14,39,41,1124,0,4,0,0,0,6,5,26,26,0
SSC10784,Cams Wharf,363,63,74,137,117,1524,0,6,0,7,13,10,26,69,65,4
SSC10785,Canada Bay,364,617,623,1240,1005,1989,0,90,67,19,197,113,165,645,608,37
SSC10786,Canadian Lead,365,3,9,12,8,0,0,3,0,0,0,0,0,3,3,0
SSC10788,Candelo,366,337,351,688,548,1029,0,56,11,18,69,64,123,324,305,19
SSC10789,Cangai,367,17,20,37,31,1375,0,5,0,0,4,0,3,11,11,0
SSC10791,Canley Heights,368,5340,5630,10970,8832,1260,450,1277,95,27,788,527,1037,4537,4003,534
SSC10792,Canley Vale,369,5027,5194,10221,8290,1053,410,1322,135,35,786,504,885,4084,3522,562
SSC10793,Canobolas,370,237,237,474,393,1875,0,37,18,13,81,41,78,275,267,8
SSC10794,Canoelands,371,96,85,181,133,1937,0,18,3,3,15,16,33,95,95,0
SSC10796,Canowindra,372,1094,1163,2257,1817,920,0,213,26,19,172,138,392,986,934,52
SSC10797,Canterbury,373,3566,3668,7234,6118,1503,580,700,485,95,1179,582,804,3886,3647,239
SSC10798,Canton Beach,374,563,611,1174,1030,673,0,178,0,4,31,65,217,284,255,29
SSC10802,Capertee,375,75,68,143,120,756,0,24,0,0,3,13,41,57,54,3
SSC10804,Captains Flat,376,326,287,613,480,1388,0,59,21,5,49,49,122,305,285,20
SSC10806,Caragabal,377,93,97,190,140,1286,0,25,3,0,21,10,27,84,84,0
SSC10808,Carcoar,378,148,156,304,267,833,0,40,6,0,31,13,60,127,119,8
SSC10809,Cardiff,379,2875,2953,5828,4721,1231,400,399,112,67,484,371,1279,2861,2642,219
SSC10810,Cardiff Heights,380,687,759,1446,1215,1468,0,137,54,16,199,105,258,676,640,36
SSC10811,Cardiff South,381,1359,1471,2830,2260,1386,0,156,43,27,207,191,657,1447,1364,83
SSC10812,Carey Bay,382,383,513,896,776,1206,0,105,27,12,103,64,155,309,289,20
SSC10813,Cargo,383,302,295,597,444,1433,0,43,6,4,32,45,124,278,268,10
SSC10815,Caringbah,384,5608,6054,11662,9490,1568,700,906,369,181,1397,1120,2107,6221,5996,225
SSC10816,Caringbah South,385,6029,6210,12239,9736,2180,750,758,418,231,1703,1148,2077,6240,6047,193
SSC10818,Carlingford,386,11989,12405,24394,19812,1833,605,1576,2194,418,4798,1962,2228,11826,11051,775
SSC10819,Carlton,387,5377,5344,10721,8907,1600,575,892,690,141,1777,882,1119,5574,5219,355
SSC10820,Carnes Hill,388,1008,1035,2043,1447,2309,0,99,65,15,292,184,251,1046,1000,46
SSC10822,Carool,389,97,75,172,141,1281,0,15,3,0,13,11,36,86,79,7
SSC10823,Caroona,390,109,90,199,159,939,0,18,0,0,7,7,30,82,71,11
SSC10826,Carramar,391,1758,1786,3544,2897,926,0,606,69,5,267,222,397,1358,1183,175
SSC10830,Carrington,392,980,948,1928,1658,1402,0,158,101,41,341,131,331,1092,1011,81
SSC10832,Carroll,393,180,161,341,253,1196,0,46,0,5,14,17,59,140,130,10
SSC10834,Carrs Creek,394,64,65,129,109,1199,0,16,0,0,8,4,27,64,56,8
SSC10837,Carss Park,395,605,650,1255,1012,1779,0,76,75,15,231,105,157,579,547,32
SSC10838,Cartwright,396,1193,1179,2372,1861,740,388,375,24,0,81,96,267,721,614,107
SSC10839,Cartwrights Hill,397,106,83,189,152,1625,0,20,7,0,12,8,43,93,87,6
SSC10841,Carwoola,398,756,671,1427,1185,2630,0,123,99,42,178,111,263,763,741,22
SSC10843,Casino,399,5251,5662,10913,8715,875,320,1168,49,47,405,427,2008,3962,3598,364
SSC10844,Cassilis,400,157,149,306,242,1101,0,26,3,3,18,18,53,160,154,6
SSC10845,Castle Cove,401,1274,1277,2551,2028,2797,1000,164,268,58,620,193,161,1181,1140,41
SSC10846,Castle Doyle,402,84,73,157,135,1625,0,5,16,3,25,16,29,94,94,0
SSC10847,Castle Hill,403,19153,20440,39593,31881,2219,650,2618,3061,737,7659,3491,4180,20293,19267,1026
SSC10849,Castlecrag,404,1458,1480,2938,2279,3799,0,163,338,64,762,200,169,1438,1364,74
SSC10850,Castlereagh,405,598,572,1170,942,1910,750,109,11,3,91,88,234,586,575,11
SSC10851,Casuarina,406,1335,1348,2683,1968,1913,0,214,89,65,405,248,377,1344,1292,52
SSC10852,Casula,407,7635,8028,15663,12292,1584,485,1501,424,123,1605,1183,2095,7130,6595,535
SSC10853,Catalina,408,1128,1206,2334,1964,921,0,300,34,20,112,133,448,815,743,72
SSC10856,Catherine Field,409,871,785,1656,1351,1799,0,229,13,8,102,85,302,795,768,27
SSC10857,Catherine Hill Bay,410,80,77,157,136,1416,0,16,6,8,16,3,32,74,67,7
SSC10858,Cathundral,411,27,21,48,25,1187,0,3,0,0,4,7,7,20,20,0
SSC10859,Cattai,412,396,392,788,628,2013,0,65,19,7,68,61,185,429,416,13
SSC10862,Caves Beach,413,1950,2102,4052,3361,1407,475,254,95,71,416,325,847,1867,1746,121
SSC10863,Cawdor,414,219,216,435,361,2109,0,43,9,5,40,38,95,236,227,9
SSC10864,Cawongla,415,104,85,189,165,738,0,21,0,4,26,12,43,84,73,11
SSC10865,Cecil Hills,416,3489,3530,7019,5580,2137,550,555,155,56,790,528,954,3557,3355,202
SSC10866,Cecil Park,417,398,370,768,632,2011,0,68,14,5,53,48,162,405,388,17
SSC10873,Centennial Park,418,1149,1230,2379,2102,2010,0,250,288,49,695,196,178,1508,1448,60
SSC10876,Central Mangrove,419,134,133,267,227,1775,0,21,4,0,26,22,54,164,157,7
SSC10877,Central Tilba,420,139,148,287,258,909,0,38,10,0,36,28,50,133,133,0
SSC10878,Cessnock,421,7571,7607,15178,12309,990,330,2256,90,87,561,654,2984,5590,4995,595
SSC10880,Chain Valley Bay,422,1188,1276,2464,2118,844,0,266,10,15,100,139,574,839,783,56
SSC10881,Chakola,423,22,24,46,41,949,0,9,0,0,6,9,8,24,21,3
SSC10883,Charbon,424,65,61,126,109,716,0,10,0,0,3,3,20,40,31,9
SSC10884,Charles Sturt University,425,112,223,335,336,0,0,3,0,0,15,8,56,162,131,31
SSC10885,Charlestown,426,6322,6589,12911,10621,1424,430,828,399,196,1664,1035,2552,6605,6218,387
SSC10887,Charlotte Bay,427,86,82,168,147,1192,0,22,0,0,17,11,48,69,66,3
SSC10889,Charmhaven,428,1270,1288,2558,2033,1194,370,219,17,17,100,146,550,1125,1013,112
SSC10892,Chatswood,429,11786,13127,24913,20863,1881,900,1920,2969,439,6221,1788,1291,12463,11627,836
SSC10893,Chatswood West,430,738,760,1498,1222,2533,0,81,155,38,338,126,134,767,736,31
SSC10894,Chatsworth,431,82,77,159,140,1260,0,24,4,0,12,4,26,82,82,0
SSC10895,Cheero Point,432,46,43,89,80,1562,0,3,4,0,10,15,20,53,50,3
SSC10896,Cheltenham,433,1063,1179,2242,1840,3170,738,101,290,82,549,144,149,1193,1128,65
SSC10898,Cherrybrook,434,9210,9552,18762,15339,2443,750,978,1817,471,4146,1654,1567,9876,9350,526
SSC10899,Chester Hill,435,6280,6532,12812,9978,1125,465,1400,220,72,970,780,1478,4925,4430,495
SSC10901,Chifley,436,1564,1671,3235,2600,1816,1000,288,129,33,315,260,508,1549,1486,63
SSC10903,Chilcotts Grass,437,116,114,230,188,1666,0,17,10,0,33,24,42,120,116,4
SSC10904,Chillingham,438,117,115,232,195,850,0,32,9,0,13,21,54,83,78,5
SSC10905,Chinderah,439,818,751,1569,1424,664,0,188,11,0,50,73,340,488,437,51
SSC10907,Chippendale,440,4141,4476,8617,8369,1250,895,1269,1034,113,2521,580,384,4367,3864,503
SSC10908,Chipping Norton,441,4407,4598,9005,7235,1773,580,678,287,84,982,704,1456,4495,4267,228
SSC10909,Chisholm,442,723,740,1463,1070,2295,0,69,42,25,141,129,316,827,792,35
SSC10910,Chiswick,443,1357,1568,2925,2510,2220,0,307,262,75,685,266,298,1700,1638,62
SSC10911,Chittaway Bay,444,1011,1016,2027,1627,1443,445,150,28,18,129,143,429,1021,954,67
SSC10912,Chittaway Point,445,463,475,938,765,1603,0,49,16,9,59,62,248,504,474,30
SSC10915,Church Point,446,497,501,998,849,2590,0,87,81,28,187,99,119,496,478,18
SSC10916,Clandulla,447,102,87,189,165,900,0,27,0,0,3,8,31,57,52,5
SSC10918,Claremont Meadows,448,2361,2419,4780,3571,2075,0,264,113,35,438,309,830,2670,2531,139
SSC10919,Clarence,449,91,104,195,170,1187,0,25,4,0,9,25,43,87,83,4
SSC10920,Clarence Town,450,1005,987,1992,1620,1578,0,158,32,23,120,156,449,965,907,58
SSC10921,Clarendon,451,57,63,120,97,1625,0,15,0,0,9,8,20,61,61,0
SSC10922,Clarenza,452,289,262,551,462,1465,0,52,8,3,49,41,110,269,255,14
SSC10923,Clareville,453,354,394,748,633,2510,0,46,59,17,163,97,77,358,341,17
SSC10924,Claymore,454,1147,1498,2645,1768,698,500,541,4,3,18,76,197,551,410,141
SSC10927,Clearfield,455,3,0,3,10,0,0,0,0,0,0,0,0,3,3,0
SSC10928,Clemton Park,456,790,868,1658,1346,1508,0,153,43,16,153,113,225,691,657,34
SSC10929,Clergate,457,102,106,208,171,1600,0,19,0,0,13,8,42,114,110,4
SSC10932,Cliftleigh,458,444,444,888,568,1542,0,85,11,3,21,36,158,348,303,45
SSC10933,Clifton,459,11,15,26,24,1562,0,0,3,0,8,7,0,16,16,0
SSC10934,Clifton Grove,460,431,416,847,677,2132,0,41,34,26,119,83,155,446,425,21
SSC10935,Clontarf,461,825,914,1739,1374,3744,1448,111,156,31,472,125,108,815,776,39
SSC10936,Clothiers Creek,462,154,126,280,222,1968,0,39,6,9,23,29,49,142,131,11
SSC10938,Clovelly,463,2280,2459,4739,3787,2768,1375,300,478,119,1284,355,402,2729,2635,94
SSC10939,Clunes,464,436,426,862,689,1383,0,66,44,22,125,58,129,444,419,25
SSC10941,Clyde,465,5,0,5,6,0,0,0,0,0,0,0,0,3,3,0
SSC10943,Coal Point,466,851,871,1722,1496,1801,0,110,90,36,277,195,360,855,815,40
SSC10944,Coalcliff,467,96,93,189,160,2333,0,16,22,5,31,26,25,105,102,3
SSC10946,Coasters Retreat,468,26,19,45,44,0,0,28,0,0,7,0,0,9,9,0
SSC10951,Cobargo,469,368,407,775,645,760,0,85,21,8,52,53,150,295,271,24
SSC10953,Cobbadah,470,50,35,85,68,1187,0,4,0,0,10,7,20,51,51,0
SSC10954,Cobbitty,471,984,1079,2063,1627,2100,500,190,43,25,181,167,395,1068,1039,29
SSC10958,Coffee Camp,472,113,104,217,186,782,0,25,0,6,19,18,41,93,83,10
SSC10959,Coffs Harbour,473,12223,13529,25752,21271,1019,450,3022,394,258,2146,1887,4864,10932,10093,839
SSC10962,Coila,474,31,18,49,46,850,0,8,0,0,9,3,15,17,17,0
SSC10965,Colebee,475,992,939,1931,1449,2787,0,94,124,21,362,173,211,1097,1050,47
SSC10966,Coledale,476,630,634,1264,983,2154,0,74,104,45,216,97,169,668,637,31
SSC10970,Collaroy,477,3842,4025,7867,6578,2115,1100,716,379,142,1423,777,1204,4410,4268,142
SSC10971,Collaroy Plateau,478,2359,2412,4771,3654,2523,0,331,179,86,678,401,753,2508,2436,72
SSC10972,Collector,479,154,164,318,223,1786,0,20,13,6,29,32,65,162,156,6
SSC10979,Collombatti,480,339,313,652,547,1007,0,93,6,8,27,43,151,251,229,22
SSC10981,Colly Blue,481,21,13,34,26,749,0,10,0,0,0,0,0,8,8,0
SSC10983,Colo,482,38,28,66,42,1375,0,0,0,0,5,5,10,36,36,0
SSC10985,Colo Vale,483,804,807,1611,1281,1529,440,113,27,20,111,127,369,788,749,39
SSC10987,Colyton,484,4185,4255,8440,6698,1415,370,711,95,41,385,441,1442,3946,3641,305
SSC10991,Comberton,485,15,13,28,31,949,0,3,0,0,0,0,8,3,3,0
SSC10992,Comboyne,486,217,234,451,385,942,0,42,10,7,29,43,105,209,192,17
SSC10996,Como,487,1979,1995,3974,3012,2543,650,201,241,82,654,366,548,2106,2044,62
SSC10998,Conargo,488,69,47,116,102,1100,0,29,0,0,7,10,12,56,53,3
SSC10999,Concord,489,7034,7500,14534,11860,2078,738,1017,836,251,2435,1141,1810,7328,7002,326
SSC11000,Concord West,490,2887,3031,5918,4776,2072,705,434,414,112,1058,446,663,2947,2823,124
SSC11001,Condell Park,491,5777,5791,11568,8860,1392,600,1033,249,67,1032,730,1386,4772,4380,392
SSC11003,Condong,492,165,144,309,252,1230,0,32,3,3,18,16,71,140,132,8
SSC11006,Congarinni North,493,200,184,384,297,1075,0,39,7,4,23,20,92,156,147,9
SSC11010,Coniston,494,1126,1142,2268,1885,1135,0,229,71,24,216,169,392,1010,922,88
SSC11011,Conjola,495,73,73,146,126,1624,0,8,7,0,7,12,43,87,84,3
SSC11012,Conjola Park,496,177,166,343,276,922,0,40,10,3,34,24,82,135,124,11
SSC11013,Connells Point,497,1372,1453,2825,2309,2287,0,179,156,32,539,241,312,1433,1387,46
SSC11014,Constitution Hill,498,1896,2067,3963,3162,1443,450,329,193,49,499,308,514,1852,1714,138
SSC11015,Coogee,499,7168,8047,15215,13059,2396,990,1746,1643,430,4000,1180,1381,9502,9193,309
SSC11019,Cooks Hill,500,1735,1878,3613,3196,1497,550,316,280,104,840,287,473,2119,1990,129
SSC11022,Coolac,501,128,85,213,164,1089,0,18,8,4,26,15,38,113,109,4
SSC11023,Coolagolite,502,142,131,273,241,977,0,37,3,3,28,32,61,122,112,10
SSC11024,Coolah,503,653,637,1290,1036,975,0,178,10,6,92,72,225,549,520,29
SSC11025,Coolamon,504,1078,1121,2199,1716,1304,0,272,39,18,152,120,418,956,902,54
SSC11032,Coolongolook,505,190,199,389,330,836,0,58,4,0,9,21,87,137,128,9
SSC11036,Cooma,506,3358,3321,6679,5629,1006,320,1001,116,82,509,412,1304,3010,2866,144
SSC11037,Coomba Bay,507,63,61,124,113,780,0,19,10,0,8,16,35,40,36,4
SSC11038,Coomba Park,508,331,296,627,560,728,0,98,16,0,30,31,168,161,129,32
SSC11043,Coonabarabran,509,1554,1733,3287,2679,896,245,412,47,30,205,154,593,1201,1097,104
SSC11044,Coonamble,510,1358,1392,2750,2184,1015,200,505,21,11,124,105,369,1056,955,101
SSC11047,Coopernook,511,266,274,540,437,828,0,64,0,0,20,30,119,224,192,32
SSC11051,Coorabell,512,193,227,420,352,1256,0,44,24,9,79,42,45,212,196,16
SSC11052,Cooranbong,513,2598,2845,5443,4507,1232,420,580,213,92,587,475,1059,2306,2139,167
SSC11053,Cootamundra,514,3310,3469,6779,5627,910,280,747,62,56,394,417,1295,2659,2490,169
SSC11055,Cooyal,515,63,47,110,91,1906,0,12,3,0,3,4,23,54,51,3
SSC11056,Copacabana,516,1393,1336,2729,2167,1837,600,175,106,64,388,264,515,1461,1368,93
SSC11060,Copmanhurst,517,148,150,298,256,756,0,29,3,3,4,31,58,96,86,10
SSC11063,Coraki,518,612,667,1279,1033,895,0,156,4,8,42,72,253,453,425,28
SSC11065,Coramba,519,411,403,814,664,1255,0,71,16,5,63,69,184,418,395,23
SSC11070,Cordeaux Heights,520,2304,2261,4565,3698,2265,0,187,217,84,665,367,847,2624,2478,146
SSC11073,Corindi Beach,521,835,845,1680,1306,1252,0,127,24,18,130,121,349,743,673,70
SSC11075,Corlette,522,2538,2821,5359,4496,1281,0,491,136,64,533,544,1077,2267,2140,127
SSC11077,Corney Town,523,41,31,72,69,749,0,5,0,0,4,0,19,34,26,8
SSC11080,Corowa,524,2674,2804,5478,4590,998,280,654,47,46,303,306,1114,2349,2211,138
SSC11082,Corrimal,525,3143,3375,6518,5373,1230,490,512,150,80,636,518,1297,3035,2850,185
SSC11085,Corunna,526,34,27,61,60,1041,0,8,0,0,17,3,14,30,30,0
SSC11086,Cottage Point,527,52,52,104,91,2083,0,24,9,3,20,13,8,40,37,3
SSC11093,Couridjah,528,152,148,300,245,1928,0,21,0,3,24,27,60,157,151,6
SSC11094,Coutts Crossing,529,508,554,1062,813,996,0,86,4,3,36,56,229,425,382,43
SSC11097,Cowan,530,329,320,649,511,1991,0,45,30,10,80,44,130,351,338,13
SSC11099,Cowra,531,4886,5172,10058,8273,966,270,1122,74,92,557,515,1870,4108,3834,274
SSC11103,Crackenback,532,110,88,198,156,1791,0,20,12,3,15,19,37,115,112,3
SSC11105,Cranebrook,533,7708,8055,15763,12114,1874,430,991,297,141,1117,1064,3069,8445,8020,425
SSC11106,Crangan Bay,534,0,0,0,3,0,0,0,0,0,0,0,0,0,0,0
SSC11107,Craven,535,66,49,115,109,866,0,17,3,3,5,6,18,45,40,5
SSC11112,Cremorne,536,5106,6114,11220,9558,2348,1050,940,1345,314,3232,1050,776,6753,6499,254
SSC11113,Cremorne Point,537,1164,1247,2411,2080,2506,0,231,327,90,685,193,150,1373,1327,46
SSC11114,Crescent Head,538,784,748,1532,1276,1015,0,162,27,28,160,129,324,677,631,46
SSC11115,Crestwood,539,2361,2242,4603,3827,1395,0,438,177,76,519,359,767,2551,2416,135
SSC11116,Cringila,540,1138,1060,2198,1736,901,385,309,17,8,69,102,305,712,623,89
SSC11118,Cromer,541,3667,3923,7590,6000,1998,900,517,252,106,965,769,1287,3881,3763,118
SSC11119,Cronulla,542,8914,9162,18076,15838,1794,863,1845,804,345,2795,1955,3398,10549,10202,347
SSC11123,Crookwell,543,1304,1339,2643,2209,1001,0,298,24,32,133,170,554,1156,1106,50
SSC11128,Croudace Bay,544,278,293,571,433,1448,0,34,10,10,65,46,119,259,243,16
SSC11130,Crowdy Head,545,39,36,75,73,924,0,9,3,0,7,5,13,26,26,0
SSC11131,Crows Nest,546,2323,2475,4798,4154,2312,950,450,595,159,1392,419,313,3111,3005,106
SSC11132,Crowther,547,30,24,54,51,949,0,4,0,0,4,8,12,33,33,0
SSC11134,Croydon,548,5063,5555,10618,8858,1846,650,951,863,246,2020,739,975,5350,5024,326
SSC11135,Croydon Park,549,5217,5801,11018,9006,1597,575,835,585,156,1698,841,1364,5646,5359,287
SSC11138,Crystal Creek,550,124,134,258,199,1125,0,22,4,3,22,20,55,114,110,4
SSC11140,Cudal,551,297,262,559,435,1280,0,46,11,4,41,40,107,260,249,11
SSC11143,Cudgen,552,418,431,849,675,1435,0,51,17,12,79,65,190,431,401,30
SSC11145,Cudmirrah,553,148,127,275,241,915,0,24,3,3,19,17,91,103,92,11
SSC11146,Culburra Beach,554,1441,1435,2876,2484,941,340,326,48,45,175,188,645,1071,984,87
SSC11147,Culcairn,555,760,712,1472,1147,1053,0,148,12,6,80,97,282,613,588,25
SSC11148,Cullen Bullen,556,138,135,273,242,778,0,82,3,0,8,9,40,89,80,9
SSC11151,Cullerin,557,20,15,35,38,2062,0,0,0,0,8,3,4,25,25,0
SSC11154,Cumbalum,558,750,772,1522,1153,1800,0,73,35,33,187,124,307,820,778,42
SSC11161,Cundletown,559,974,1086,2060,1668,1073,0,252,27,21,85,137,399,852,793,59
SSC11163,Cunjurong Point,560,39,39,78,67,780,0,0,0,0,14,9,17,27,27,0
SSC11167,Curl Curl,561,1245,1170,2415,1829,2693,0,216,166,56,452,196,241,1182,1142,40
SSC11170,Curlwaa,562,209,178,387,331,1125,0,49,3,0,26,18,92,217,204,13
SSC11172,Currabubula,563,162,173,335,266,1116,0,36,3,7,17,19,63,167,160,7
SSC11174,Curramore,564,97,98,195,164,1963,0,19,3,3,46,13,24,94,91,3
SSC11175,Currans Hill,565,2593,2711,5304,3887,1860,440,236,74,48,350,413,980,2928,2782,146
SSC11176,Currarong,566,239,212,451,421,844,0,72,10,11,46,25,111,151,144,7
SSC11185,Daceyville,567,520,693,1213,1071,498,0,231,40,5,87,64,156,346,300,46
SSC11188,Dairymans Plains,568,79,75,154,132,1833,0,6,5,3,21,8,38,85,85,0
SSC11189,Daleys Point,569,315,369,684,602,934,0,70,18,6,87,61,137,235,220,15
SSC11190,Dalgety,570,118,90,208,176,966,0,12,4,7,19,15,52,108,108,0
SSC11191,Dalmeny,571,907,1025,1932,1653,901,0,273,23,31,140,133,387,593,555,38
SSC11198,Dandry,572,49,47,96,79,725,0,11,0,3,3,4,17,30,27,3
SSC11199,Dangar Island,573,138,163,301,242,1375,0,26,40,11,56,20,34,127,118,9
SSC11202,Dapto,574,5256,5478,10734,8692,1238,450,789,138,85,574,660,2424,4872,4505,367
SSC11203,Darawank,575,212,191,403,304,1169,0,37,7,0,29,24,88,151,133,18
SSC11205,Darbys Falls,576,137,110,247,228,955,0,38,0,0,11,19,56,108,96,12
SSC11206,Dareton,577,255,247,502,412,744,0,85,3,5,17,12,74,127,104,23
SSC11207,Dargan,578,50,40,90,88,771,0,18,3,0,11,7,22,33,29,4
SSC11209,Darkes Forest,579,56,59,115,96,2042,0,18,4,0,10,15,23,59,59,0
SSC11211,Darling Point,580,1897,2291,4188,3754,2966,0,651,515,101,1109,311,242,2128,2071,57
SSC11212,Darlinghurst,581,6547,4773,11320,10773,2158,850,2035,1439,292,3499,884,734,7459,7118,341
SSC11214,Darlington,582,1482,1617,3099,2932,1111,0,290,353,67,1030,149,146,1645,1483,162
SSC11219,Davidson,583,1404,1447,2851,2275,2630,0,150,151,71,500,292,370,1503,1449,54
SSC11221,Davistown,584,1205,1283,2488,2077,1176,490,194,29,27,168,232,591,1088,1026,62
SSC11222,Dawes Point,585,177,184,361,328,3806,0,37,67,7,113,24,12,216,212,4
SSC11224,Dean Park,586,1568,1656,3224,2508,1600,365,274,73,18,267,205,548,1546,1442,104
SSC11227,Dee Why,587,10552,10963,21515,18056,1716,795,1931,1078,363,3786,2183,3186,12860,12387,473
SSC11229,Deep Creek,588,49,44,93,74,1021,0,7,0,0,4,6,27,30,24,6
SSC11231,Deepwater,589,223,210,433,395,665,0,69,4,3,21,29,92,145,133,12
SSC11233,Delegate,590,187,163,350,304,854,0,38,0,0,15,23,58,169,155,14
SSC11234,Delungra,591,338,307,645,500,782,0,74,4,10,26,25,115,268,249,19
SSC11235,Denham Court,592,1071,917,1988,1702,1777,550,280,73,18,249,136,348,823,790,33
SSC11237,Deniliquin,593,3808,4059,7867,6499,1063,270,1063,85,80,478,428,1429,3488,3299,189
SSC11238,Denistone,594,1864,1887,3751,3107,2333,685,188,348,96,849,266,343,1935,1854,81
SSC11239,Denistone East,595,1105,1148,2253,1760,2129,0,130,218,41,444,175,207,1090,1051,39
SSC11240,Denistone West,596,464,465,929,715,2128,0,54,100,17,196,69,77,460,442,18
SSC11241,Denman,597,898,890,1788,1419,1176,0,167,8,8,58,99,367,813,779,34
SSC11243,Derriwong,598,22,19,41,27,1187,0,3,0,0,0,0,10,12,12,0
SSC11248,Dharruk,599,1361,1417,2778,2131,1281,0,250,26,12,135,143,390,1152,1025,127
SSC11250,Dhuragoon,600,12,15,27,20,1625,0,0,0,0,0,0,5,16,16,0
SSC11251,Diamond Beach,601,424,455,879,735,1187,0,73,15,17,77,96,218,404,369,35
SSC11256,Dilkoon,602,22,25,47,38,674,0,3,0,0,0,3,15,19,15,4
SSC11261,Dirty Creek,603,48,41,89,74,1083,0,14,0,0,3,6,18,39,30,9
SSC11266,Dolans Bay,604,296,299,595,504,2815,0,23,30,10,100,69,103,340,340,0
SSC11267,Dolls Point,605,765,894,1659,1412,1438,0,134,62,25,238,196,287,924,877,47
SSC11273,Doon Doon,606,49,43,92,88,749,0,20,3,0,12,8,14,39,35,4
SSC11274,Doonbah,607,121,121,242,225,772,0,33,0,0,16,13,45,76,70,6
SSC11275,Doonside,608,6611,6835,13446,10714,1340,380,1217,326,81,1314,834,1759,5949,5396,553
SSC11276,Dooralong,609,199,154,353,316,1724,0,31,9,4,36,34,67,162,151,11
SSC11277,Dora Creek,610,848,795,1643,1411,1154,0,160,33,16,110,110,388,722,662,60
SSC11278,Dorrigo,611,545,645,1190,1032,775,320,119,15,18,94,70,229,439,412,27
SSC11280,Dorroughby,612,65,72,137,115,1140,0,22,3,0,21,8,20,70,67,3
SSC11281,Double Bay,613,2036,2608,4644,4116,2478,1500,544,554,104,1377,349,255,2630,2540,90
SSC11283,Douglas Park,614,699,662,1361,1097,1943,0,108,28,19,119,94,298,695,668,27
SSC11284,Dover Heights,615,1817,1984,3801,2999,3031,1450,251,334,66,1026,302,217,1904,1842,62
SSC11286,Doyalson,616,165,149,314,255,1231,0,11,0,0,8,14,56,150,140,10
SSC11287,Doyalson North,617,177,206,383,375,666,0,50,0,0,9,23,94,62,59,3
SSC11293,Drummoyne,618,5613,6337,11950,10040,2353,750,1237,1055,311,2627,1021,1194,6568,6329,239
SSC11296,Dubbo,619,18751,20193,38944,30694,1341,350,3626,721,488,3443,2270,7375,19151,18099,1052
SSC11298,Duckenfield,620,56,54,110,92,1202,0,3,3,0,11,4,34,60,60,0
SSC11300,Dudley,621,1190,1223,2413,1902,1991,478,149,130,40,410,208,395,1178,1124,54
SSC11301,Duffys Forest,622,233,248,481,382,3274,0,18,21,5,100,32,58,259,249,10
SSC11303,Dulwich Hill,623,6540,7175,13715,11564,1809,700,1371,1157,428,2774,1062,1406,7868,7491,377
SSC11310,Dunbogan,624,504,493,997,925,875,0,95,12,14,65,83,255,368,331,37
SSC11312,Dundas,625,2313,2424,4737,3836,1701,0,395,293,75,747,357,541,2313,2176,137
SSC11313,Dundas Valley,626,2650,2761,5411,4364,1551,495,433,381,65,840,382,639,2667,2484,183
SSC11316,Dunedoo,627,605,613,1218,998,871,0,216,8,5,59,55,172,444,406,38
SSC11320,Dungog,628,976,1047,2023,1697,842,325,231,22,21,124,109,391,762,706,56
SSC11322,Dunkeld,629,23,18,41,42,1958,0,7,3,0,8,0,15,24,24,0
SSC11323,Dunmore,630,106,102,208,174,1775,0,9,5,0,19,18,47,109,106,3
SSC11326,Duns Creek,631,291,255,546,424,1775,0,31,10,9,56,51,106,277,264,13
SSC11328,Dural,632,3676,3894,7570,6196,2164,655,514,398,134,1270,675,1005,3865,3724,141
SSC11331,Duranbah,633,122,112,234,200,1312,0,29,3,3,24,16,47,126,120,6
SSC11332,Duri,634,270,259,529,424,1447,0,49,6,3,33,26,130,276,272,4
SSC11335,Durras North,635,14,8,22,24,1062,0,5,0,0,7,0,7,5,5,0
SSC11336,Durren Durren,636,32,46,78,60,1624,0,4,3,0,9,8,17,47,47,0
SSC11338,Dyers Crossing,637,171,170,341,287,1042,0,32,6,4,20,26,86,161,150,11
SSC11341,Eagle Vale,638,2886,2899,5785,4593,1612,400,372,80,37,391,421,1072,3008,2806,202
SSC11343,Earlwood,639,8754,8988,17742,14497,1824,670,1732,800,249,2445,1323,2160,8469,8084,385
SSC11344,East Albury,640,2879,3224,6103,5022,1327,0,490,183,149,830,496,1069,3145,2976,169
SSC11345,East Ballina,641,2734,2838,5572,4661,1266,0,385,156,145,787,491,1092,2676,2546,130
SSC11346,East Branxton,642,896,917,1813,1318,1710,0,128,18,11,78,111,439,886,830,56
SSC11348,East Corrimal,643,1703,1700,3403,2787,1276,0,226,136,60,357,263,689,1693,1573,120
SSC11349,East Gosford,644,1964,2278,4242,3544,1065,0,445,131,58,536,390,696,1871,1754,117
SSC11350,East Gresford,645,155,154,309,240,1062,0,25,5,0,12,20,62,149,142,7
SSC11351,East Hills,646,1602,1609,3211,2652,1511,0,239,96,31,355,260,554,1615,1522,93
SSC11352,East Jindabyne,647,353,342,695,543,1656,0,42,29,14,111,66,144,404,394,10
SSC11353,East Kangaloon,648,48,38,86,79,1625,0,11,5,3,13,13,12,54,54,0
SSC11354,East Kempsey,649,635,717,1352,1062,930,0,154,9,18,90,68,255,533,502,31
SSC11355,East Killara,650,1495,1481,2976,2441,2524,0,184,297,46,726,189,180,1381,1290,91
SSC11356,East Kurrajong,651,1137,1062,2199,1705,2187,0,190,47,22,156,184,484,1155,1122,33
SSC11357,East Lindfield,652,1787,1924,3711,2880,3047,0,162,400,86,924,282,196,1724,1629,95
SSC11358,East Lismore,653,2321,2670,4991,4107,1000,0,568,122,62,478,262,916,2143,1953,190
SSC11359,East Lynne,654,49,50,99,81,850,0,9,6,5,6,11,24,46,43,3
SSC11360,East Maitland,655,5716,6065,11781,9681,1178,0,1016,232,145,1055,852,2369,5483,5052,431
SSC11361,East Ryde,656,1182,1271,2453,1928,2585,0,78,207,58,492,243,257,1296,1238,58
SSC11363,East Tamworth,657,2440,2907,5347,4380,1368,0,486,180,129,771,399,892,2660,2531,129
SSC11364,East Wagga Wagga,658,118,118,236,187,1062,0,30,3,8,15,14,55,103,95,8
SSC11366,Eastern Creek,659,420,411,831,614,1613,0,46,10,0,55,39,145,387,367,20
SSC11367,Eastgardens,660,427,437,864,717,1833,0,91,48,15,110,60,110,394,381,13
SSC11368,Eastlakes,661,3452,3458,6910,5660,1051,690,674,390,73,959,482,706,3104,2836,268
SSC11369,Eastwood,662,8700,9165,17865,15151,1648,650,1181,2083,300,3900,1405,1282,8884,8176,708
SSC11370,Eatonsville,663,108,113,221,174,794,0,12,3,4,5,18,45,84,71,13
SSC11371,Ebenezer,664,507,482,989,787,1886,483,79,13,5,52,78,251,536,515,21
SSC11372,Ebor,665,87,75,162,145,791,0,27,0,0,12,5,32,83,79,4
SSC11375,Eden,666,1542,1609,3151,2648,852,400,447,33,27,167,176,577,1216,1130,86
SSC11377,Edensor Park,667,4773,4999,9772,8000,1637,480,918,145,31,912,685,1241,4535,4173,362
SSC11379,Edgecliff,668,1156,1422,2578,2299,2198,0,398,289,84,739,208,146,1408,1362,46
SSC11380,Edgeroi,669,60,46,106,88,1625,0,12,0,0,12,6,13,57,50,7
SSC11381,Edgeworth,670,2995,3211,6206,5026,1167,410,437,29,29,267,340,1421,2837,2648,189
SSC11382,Edith,671,52,41,93,79,1583,0,10,0,0,13,5,16,49,49,0
SSC11383,Edmondson Park,672,1127,1147,2274,1657,2275,570,194,122,22,308,177,215,1117,1049,68
SSC11386,Eglinton,673,1108,1147,2255,1728,1565,0,157,33,30,181,139,516,1156,1113,43
SSC11388,Elands,674,111,96,207,169,468,0,40,3,0,21,12,33,63,50,13
SSC11389,Elanora Heights,675,2150,2213,4363,3319,2461,735,241,203,89,675,444,658,2294,2222,72
SSC11391,Elderslie,676,2895,3110,6005,4545,2013,490,348,139,83,592,485,1184,3241,3107,134
SSC11393,Eleebana,677,2823,2936,5759,4654,1969,500,311,252,128,882,529,1023,2908,2757,151
SSC11394,Elermore Vale,678,2611,2913,5524,4500,1325,440,458,186,67,624,358,1051,2574,2371,203
SSC11395,Elizabeth Bay,679,2624,2586,5210,5007,1989,0,860,780,164,1634,431,323,3457,3329,128
SSC11396,Elizabeth Beach,680,109,105,214,182,1137,0,31,8,4,19,17,52,101,98,3
SSC11397,Elizabeth Hills,681,1255,1279,2534,1781,2003,0,226,76,18,307,197,319,1198,1142,56
SSC11398,Ellalong,682,535,560,1095,868,1370,0,88,8,16,46,71,249,499,469,30
SSC11405,Ellis Lane,683,440,419,859,676,2356,0,30,27,12,104,67,198,460,441,19
SSC11406,Elong Elong,684,58,60,118,93,771,0,8,0,3,15,11,26,51,48,3
SSC11407,Elrington,685,60,53,113,97,2333,0,8,0,0,11,7,34,67,67,0
SSC11408,Elsmore,686,174,180,354,282,474,0,98,3,0,17,33,49,66,63,3
SSC11411,Emerald Beach,687,1068,1168,2236,1761,1410,463,128,55,29,304,196,487,1118,1041,77
SSC11412,Emerald Hill,688,76,64,140,103,1792,0,23,0,0,7,10,26,71,71,0
SSC11413,Emerton,689,1132,1126,2258,1678,1072,315,242,15,6,65,74,299,822,704,118
SSC11414,Emmaville,690,262,257,519,446,768,0,90,5,4,17,25,85,195,168,27
SSC11415,Empire Bay,691,1185,1210,2395,1908,1449,0,187,37,30,189,190,537,1133,1070,63
SSC11417,Emu Heights,692,1636,1651,3287,2600,2080,0,143,101,48,268,250,672,1893,1820,73
SSC11418,Emu Plains,693,3969,4446,8415,6824,1685,460,769,217,107,695,623,1577,4071,3893,178
SSC11421,Enfield,694,1403,1434,2837,2391,1595,580,239,179,31,479,229,304,1499,1416,83
SSC11422,Engadine,695,8573,8803,17376,13303,1962,620,863,457,242,1792,1544,3614,8957,8690,267
SSC11423,Englorie Park,696,195,223,418,314,1552,0,38,10,3,62,28,58,211,193,18
SSC11425,Enmore,697,1942,1945,3887,3426,2022,0,451,426,130,1021,301,332,2467,2354,113
SSC11428,Epping,698,11697,11992,23689,19656,1973,650,1276,3080,510,5766,1779,1529,12202,11304,898
SSC11429,Eraring,699,112,103,215,177,1312,0,18,11,4,28,22,50,80,80,0
SSC11431,Erigolia,700,29,25,54,28,1375,0,3,0,0,9,3,5,25,25,0
SSC11433,Erina,701,2051,2726,4777,4193,941,520,663,119,39,465,371,774,1623,1541,82
SSC11434,Erina Heights,702,219,203,422,318,1974,0,30,16,12,54,43,66,209,199,10
SSC11435,Ermington,703,5352,5386,10738,8559,1620,520,877,515,108,1438,844,1405,5128,4835,293
SSC11436,Erowal Bay,704,329,300,629,528,1093,370,48,18,14,45,48,164,276,255,21
SSC11438,Erskine Park,705,3199,3238,6437,5199,2104,393,352,125,42,547,444,1302,3854,3669,185
SSC11439,Erskineville,706,4119,3894,8013,7127,2482,730,792,1076,249,2339,646,638,5610,5418,192
SSC11441,Eschol Park,707,1278,1310,2588,2049,1649,0,131,45,16,163,202,567,1452,1360,92
SSC11444,Estella,708,1035,1236,2271,1827,1620,0,172,99,26,309,156,397,1181,1126,55
SSC11445,Ettalong Beach,709,2263,2525,4788,4154,867,0,542,84,46,339,325,936,1832,1664,168
SSC11449,Euabalong,710,105,85,190,142,919,0,9,0,0,8,5,30,80,75,5
SSC11450,Euabalong West,711,34,26,60,43,850,0,4,0,4,0,0,4,13,13,0
SSC11452,Euchareena,712,98,101,199,147,1228,0,36,0,0,12,8,32,73,70,3
SSC11454,Eugowra,713,396,376,772,659,1095,0,83,7,8,37,43,160,349,336,13
SSC11456,Eumungerie,714,168,134,302,260,836,0,55,0,0,19,17,62,144,133,11
SSC11457,Eunanoreenya,715,81,87,168,134,1843,0,17,5,5,22,9,26,93,93,0
SSC11458,Eungai Creek,716,226,193,419,332,905,0,35,0,3,25,27,113,189,160,29
SSC11459,Eungai Rail,717,119,103,222,182,788,0,32,0,0,9,12,36,81,63,18
SSC11460,Eungella,718,188,153,341,261,1024,0,52,7,4,34,24,62,126,116,10
SSC11461,Eureka,719,171,180,351,268,1368,0,30,12,5,50,35,49,161,151,10
SSC11467,Eurunderee,720,81,80,161,129,1774,0,15,0,4,36,15,23,100,97,3
SSC11469,Evans Head,721,1392,1459,2851,2416,900,478,328,46,29,203,183,574,1108,1030,78
SSC11471,Eveleigh,722,296,371,667,550,1221,0,107,44,9,122,53,70,362,339,23
SSC11474,Ewingsdale,723,412,417,829,677,1592,0,133,26,13,121,66,118,385,368,17
SSC11475,Exeter,724,457,494,951,798,1362,0,65,48,27,167,116,151,452,434,18
SSC11477,Fairfield,725,8968,9115,18083,14639,975,440,2450,304,71,1359,1082,1698,6164,5265,899
SSC11478,Fairfield East,726,2653,2616,5269,4168,1057,0,779,54,11,358,254,470,1813,1619,194
SSC11479,Fairfield Heights,727,3658,3859,7517,5935,1116,0,970,90,42,496,468,670,2484,2192,292
SSC11480,Fairfield West,728,5669,5899,11568,9273,1267,0,1250,148,47,730,629,1357,4631,4176,455
SSC11482,Fairlight,729,2787,3052,5839,4810,2620,1213,404,570,179,1484,527,518,3412,3304,108
SSC11483,Fairy Hill,730,192,192,384,307,1118,0,35,4,3,24,30,62,173,160,13
SSC11484,Fairy Meadow,731,3672,3728,7400,6249,1123,525,639,361,85,879,531,1324,3385,3072,313
SSC11487,Falls Creek,732,497,436,933,799,1478,0,100,15,10,57,61,234,437,420,17
SSC11490,Farley,733,114,101,215,180,1895,0,17,3,0,23,8,49,109,106,3
SSC11491,Farmborough Heights,734,2028,2165,4193,3378,1816,0,323,138,71,478,389,849,2156,2054,102
SSC11495,Fassifern,735,297,300,597,527,1238,0,61,14,3,43,34,147,297,273,24
SSC11496,Faulconbridge,736,1969,2060,4029,3188,1781,0,186,211,117,590,346,680,2109,2022,87
SSC11499,Federal,737,340,351,691,562,1184,0,100,37,23,98,65,107,316,296,20
SSC11500,Fennell Bay,738,782,831,1613,1372,1204,0,123,28,14,120,111,381,722,647,75
SSC11501,Fern Bay,739,1368,1398,2766,2337,1049,0,255,60,24,242,187,558,998,935,63
SSC11505,Fernbank Creek,740,68,64,132,115,1321,0,8,3,0,16,13,23,70,66,4
SSC11507,Fernhill,741,503,522,1025,870,870,0,103,23,17,75,65,194,378,345,33
SSC11512,Ferodale,742,46,44,90,75,1625,0,6,0,0,3,3,29,43,40,3
SSC11515,Figtree,743,5712,5844,11556,9275,1581,500,711,527,233,1435,947,2050,5520,5192,328
SSC11518,Fingal Bay,744,769,843,1612,1448,908,0,296,29,18,92,124,386,501,462,39
SSC11519,Fingal Head,745,297,299,596,484,1208,0,80,8,8,73,54,79,253,233,20
SSC11520,Finley,746,1237,1280,2517,2081,988,0,344,18,14,151,124,447,1071,1019,52
SSC11523,Fishermans Paradise,747,250,225,475,393,773,0,87,8,3,16,20,108,136,126,10
SSC11526,Fishing Point,748,525,515,1040,892,1355,0,56,25,30,108,120,236,460,429,31
SSC11529,Fitzroy Falls,749,106,114,220,165,1666,0,17,7,3,43,18,27,103,103,0
SSC11530,Five Dock,750,4441,4915,9356,7611,2077,755,870,589,193,1619,773,1073,4935,4716,219
SSC11533,Fletcher,751,2555,2578,5133,3653,2296,523,214,200,66,589,371,901,2751,2596,155
SSC11534,Flinders,752,3293,3387,6680,5085,1783,550,419,130,69,537,545,1399,3447,3249,198
SSC11535,Floraville,753,923,935,1858,1430,1848,0,79,35,20,210,152,385,935,895,40
SSC11536,Forbes,754,4183,4244,8427,6752,1033,280,1012,70,65,488,435,1498,3552,3339,213
SSC11539,Forbesdale,755,96,83,179,138,1275,0,14,0,0,11,9,34,82,78,4
SSC11542,Forest Glen,756,40,29,69,50,1749,0,7,0,0,4,5,18,40,40,0
SSC11546,Forest Lodge,757,2219,2366,4585,4099,2143,900,408,692,128,1378,311,262,2832,2662,170
SSC11548,Forestville,758,4025,4301,8326,6425,2151,850,484,522,167,1474,688,917,3955,3811,144
SSC11549,Forresters Beach,759,1417,1482,2899,2322,1520,510,203,98,51,356,267,554,1394,1334,60
SSC11550,Forster,760,6511,7230,13741,11807,868,430,1613,177,145,949,961,2794,4745,4368,377
SSC11554,Fountaindale,761,352,354,706,573,2293,0,41,22,12,95,60,141,367,354,13
SSC11558,Foxground,762,69,80,149,129,1458,0,19,12,6,25,10,30,77,77,0
SSC11561,Frederickton,763,637,754,1391,1123,1003,0,138,4,5,46,64,285,525,482,43
SSC11564,Freemans Reach,764,1010,969,1979,1568,1885,0,122,27,19,137,149,426,1074,1039,35
SSC11565,Freemans Waterhole,765,54,45,99,88,634,0,11,4,0,4,5,24,53,43,10
SSC11567,French Park,766,13,15,28,18,1812,0,3,0,0,0,0,7,16,16,0
SSC11568,Frenchs Forest,767,6680,6793,13473,10307,2514,875,628,793,233,2350,1291,1676,7012,6730,282
SSC11569,Freshwater,768,4369,4499,8868,7025,2268,1350,615,596,189,1909,852,1114,5128,4985,143
SSC11572,Frogs Hollow,769,62,52,114,88,1125,0,8,0,0,6,6,34,44,41,3
SSC11575,Fullerton Cove,770,288,278,566,521,1082,0,85,8,6,38,45,138,181,170,11
SSC11580,Galong,771,130,95,225,169,814,0,27,3,0,18,15,39,94,87,7
SSC11582,Galston,772,1527,1605,3132,2537,1798,650,197,134,51,438,311,561,1553,1498,55
SSC11585,Ganmain,773,383,397,780,611,935,0,83,7,5,37,33,130,296,261,35
SSC11587,Garden Suburb,774,939,970,1909,1578,1856,0,184,90,37,258,140,322,960,912,48
SSC11594,Gateshead,775,1519,1621,3140,2470,926,0,251,20,10,108,140,615,1219,1083,136
SSC11598,Gemalla,776,10,12,22,13,1625,0,0,0,3,5,0,0,13,13,0
SSC11601,Georges Hall,777,4385,4658,9043,7043,1464,550,940,197,55,761,602,1308,3754,3537,217
SSC11602,Georges Plains,778,129,119,248,203,1625,0,51,4,4,16,19,55,109,101,8
SSC11603,Georgetown,779,926,1027,1953,1610,1381,0,116,66,28,285,137,351,1038,958,80
SSC11605,Gerogery,780,292,276,568,433,1510,0,45,6,4,52,39,129,295,286,9
SSC11606,Gerringong,781,1895,2074,3969,3218,1496,555,403,147,95,532,369,690,1779,1718,61
SSC11607,Gerroa,782,336,339,675,587,1448,0,98,30,14,112,59,87,302,289,13
SSC11608,Geurie,783,379,375,754,589,1218,0,72,14,8,47,55,187,366,347,19
SSC11615,Gidginbung,784,29,36,65,48,1468,0,6,0,0,3,3,16,28,28,0
SSC11617,Gilead,785,169,245,414,414,782,0,177,3,3,21,26,59,50,50,0
SSC11618,Gilgai,786,357,361,718,588,944,0,100,0,0,25,27,159,303,275,28
SSC11619,Gilgandra,787,1509,1615,3124,2539,914,260,391,27,11,152,121,563,1258,1168,90
SSC11624,Gillieston Heights,788,1559,1591,3150,2339,1712,0,188,48,24,203,199,737,1623,1529,94
SSC11631,Girards Hill,789,624,694,1318,1103,1002,0,117,43,44,178,101,232,584,519,65
SSC11632,Girilambone,790,53,48,101,83,1437,0,14,0,0,3,4,16,55,52,3
SSC11634,Girral,791,33,23,56,47,1624,0,0,0,0,4,0,12,32,32,0
SSC11636,Girraween,792,2848,2739,5587,4200,1779,480,388,533,74,864,359,468,2538,2352,186
SSC11638,Gladesville,793,5682,6148,11830,9651,1922,700,880,899,243,2364,1062,1269,6361,6091,270
SSC11639,Gladstone,794,178,205,383,322,892,0,47,3,3,20,14,63,152,133,19
SSC11641,Glebe,795,5383,6153,11536,10465,1579,850,1522,1441,276,2855,777,807,6285,5864,421
SSC11642,Gledswood Hills,796,13,14,27,22,900,0,3,0,0,3,0,12,8,8,0
SSC11645,Glen Alpine,797,2275,2278,4553,3764,2440,580,269,161,70,534,423,795,2655,2529,126
SSC11649,Glen Innes,798,2926,3226,6152,5013,833,250,774,67,46,343,363,1099,2401,2202,199
SSC11652,Glen Oak,799,174,173,347,289,1694,0,41,3,3,24,30,96,180,170,10
SSC11656,Glenbrook,800,2507,2544,5051,4066,2094,0,278,328,143,895,470,763,2650,2557,93
SSC11657,Glencoe,801,95,93,188,159,1047,0,30,0,0,14,10,35,84,76,8
SSC11658,Glendale,802,1501,1602,3103,2503,1204,375,189,41,24,245,193,706,1424,1304,120
SSC11659,Glendenning,803,2541,2585,5126,3771,1906,420,284,182,44,627,389,640,2659,2467,192
SSC11664,Glenfield,804,4718,4915,9633,7539,1757,475,943,696,99,1282,678,1183,4754,4379,375
SSC11665,Glenfield Park,805,2503,2730,5233,4062,1395,0,388,59,38,382,300,1100,2721,2582,139
SSC11667,Glenhaven,806,3157,3347,6504,5304,2259,750,396,312,132,1133,677,879,3259,3135,124
SSC11670,Glenmore Park,807,11155,11854,23009,17369,2213,490,1119,642,257,2210,1908,3927,13154,12635,519
SSC11671,Glennies Creek,808,16,19,35,30,1291,0,3,0,0,3,0,7,19,19,0
SSC11672,Glenning Valley,809,957,1057,2014,1611,1888,0,118,47,25,208,170,418,1099,1054,45
SSC11673,Glenorie,810,1729,1762,3491,2803,1991,0,303,118,42,428,248,615,1797,1747,50
SSC11674,Glenquarry,811,110,118,228,166,1625,0,17,7,0,38,16,32,113,113,0
SSC11675,Glenreagh,812,466,436,902,698,995,0,98,7,5,44,51,194,343,311,32
SSC11676,Glenridding,813,136,121,257,219,945,0,23,0,0,6,7,57,115,105,10
SSC11680,Glenthorne,814,119,114,233,196,900,0,39,0,3,14,25,53,90,86,4
SSC11682,Glenwood,815,7983,8148,16131,12386,2476,600,739,1171,198,2808,1251,1700,8932,8390,542
SSC11684,Glossodia,816,1430,1393,2823,2147,1910,0,196,32,32,162,181,739,1569,1522,47
SSC11685,Gloucester,817,1399,1580,2979,2462,848,345,275,15,26,166,185,587,1098,1005,93
SSC11689,Gobbagombalin,818,235,239,474,367,2138,0,35,13,4,62,39,117,286,280,6
SSC11693,Gol Gol,819,779,746,1525,1150,1527,0,109,21,24,117,114,299,757,733,24
SSC11696,Gongolgon,820,21,13,34,36,537,0,0,0,0,4,3,6,21,17,4
SSC11698,Goobarragandra,821,37,31,68,58,1350,0,6,3,3,9,3,14,28,28,0
SSC11704,Googong,822,1332,1359,2691,2010,2813,0,200,122,55,371,262,393,1509,1477,32
SSC11705,Goolgowi,823,218,181,399,320,1197,0,32,3,3,20,17,75,208,208,0
SSC11708,Goolmangar,824,95,91,186,149,1215,0,14,4,7,17,8,36,98,94,4
SSC11711,Goonellabah,825,5997,6902,12899,10472,1096,400,1216,215,154,1232,789,2584,5758,5358,400
SSC11712,Goonengerry,826,187,180,367,303,846,0,42,19,4,58,34,58,169,151,18
SSC11718,Gordon,827,3658,4001,7659,6284,2313,963,589,987,167,2057,486,397,3788,3564,224
SSC11720,Gormans Hill,828,353,437,790,656,881,0,154,8,15,53,35,138,287,263,24
SSC11721,Gorokan,829,4080,4288,8368,6857,989,350,917,65,50,357,448,1752,3374,3060,314
SSC11722,Gosford,830,1855,1649,3504,3104,1203,0,438,153,38,558,273,592,1940,1751,189
SSC11724,Gostwyck,831,14,14,28,23,2250,0,0,0,0,3,0,5,18,18,0
SSC11725,Goulburn,832,11220,11200,22420,18360,1155,360,2882,348,244,1376,1527,4262,10171,9471,700
SSC11731,Grabben Gullen,833,135,122,257,212,956,0,46,6,4,6,15,61,109,105,4
SSC11733,Grafton,834,5010,5405,10415,8524,956,360,1361,104,100,660,571,1997,4153,3792,361
SSC11735,Grahamstown,835,32,26,58,54,1125,0,8,0,0,5,3,8,30,30,0
SSC11738,Granville,836,8066,7267,15333,12462,1332,460,1831,976,133,2138,1129,1293,7301,6518,783
SSC11739,Grasmere,837,883,1084,1967,1715,1401,0,339,38,30,169,134,359,764,747,17
SSC11740,Grassy Head,838,45,36,81,73,900,0,13,3,0,9,5,22,40,40,0
SSC11743,Grays Point,839,1551,1570,3121,2497,2557,750,145,176,78,487,299,564,1761,1703,58
SSC11744,Great Mackerel Beach,840,19,21,40,36,725,0,4,3,0,12,3,5,17,17,0
SSC11752,Green Pigeon,841,85,77,162,131,714,0,19,4,3,13,12,36,70,65,5
SSC11753,Green Point,842,3032,3368,6400,5290,1324,570,446,157,102,682,577,1163,3022,2842,180
SSC11756,Green Valley,843,6126,6384,12510,9878,1572,470,1181,146,62,987,803,1561,5702,5228,474
SSC11757,Greenacre,844,12107,12268,24375,18446,1184,550,2562,637,150,2052,1442,2583,9026,8229,797
SSC11760,Greenethorpe,845,123,119,242,193,956,0,50,0,0,20,16,37,87,81,6
SSC11761,Greenfield Park,846,2543,2546,5089,4098,1489,430,500,70,23,437,343,546,2103,1924,179
SSC11762,Greengrove,847,10,11,21,15,3499,0,3,4,0,3,0,0,6,6,0
SSC11763,Greenhill,848,364,366,730,560,879,0,113,3,7,28,32,115,205,189,16
SSC11769,Greenwell Point,849,639,572,1211,1088,876,0,147,12,18,66,72,284,462,432,30
SSC11770,Greenwich,850,2690,2918,5608,4676,2555,1100,429,738,150,1593,409,327,3072,2936,136
SSC11774,Gregory Hills,851,2519,2467,4986,3679,2343,0,311,146,40,556,426,851,2751,2649,102
SSC11775,Greigs Flat,852,82,69,151,115,1221,0,6,3,0,11,9,42,64,64,0
SSC11776,Grenfell,853,1279,1293,2572,2167,841,0,286,21,19,148,124,486,1022,962,60
SSC11777,Gresford,854,128,114,242,203,1192,0,36,3,3,9,22,45,102,98,4
SSC11778,Greta,855,1445,1386,2831,2114,1412,350,194,17,16,99,112,686,1319,1205,114
SSC11779,Greta Main,856,38,27,65,59,2062,0,6,0,0,0,6,28,34,31,3
SSC11781,Greystanes,857,11224,11583,22807,18089,1608,500,1794,593,191,2282,1611,3555,10693,10068,625
SSC11782,Griffith,858,8971,9225,18196,14420,1287,360,2381,237,152,1222,885,2909,8484,8028,456
SSC11784,Grong Grong,859,123,125,248,194,1218,0,34,0,4,15,12,44,129,125,4
SSC11785,Grose Vale,860,639,621,1260,1031,2128,0,69,45,22,151,114,282,678,663,15
SSC11786,Grose Wold,861,323,313,636,524,2239,0,49,14,16,45,57,131,329,319,10
SSC11790,Guildford,862,11315,11014,22329,17074,1120,450,2544,573,103,1844,1410,2398,8352,7425,927
SSC11791,Guildford West,863,2424,2494,4918,3758,1388,455,466,90,18,364,306,655,2092,1928,164
SSC11792,Gulargambone,864,295,295,590,475,788,0,116,0,7,19,12,73,191,166,25
SSC11794,Gulgong,865,1246,1272,2518,1971,1086,0,326,16,11,107,115,495,1028,939,89
SSC11800,Gumly Gumly,866,165,141,306,249,1375,0,32,0,0,11,17,76,143,140,3
SSC11803,Gundagai,867,823,854,1677,1382,1022,290,205,13,12,101,87,292,725,693,32
SSC11805,Gundaroo,868,585,566,1151,870,2493,0,70,96,47,187,101,152,615,603,12
SSC11808,Gunderman,869,102,95,197,173,1194,0,53,4,0,17,13,28,69,65,4
SSC11812,Gunnedah,870,4785,4946,9731,7664,1270,350,1027,108,82,604,492,1838,4427,4179,248
SSC11813,Gunning,871,330,330,660,521,1493,0,60,10,22,55,47,131,317,300,17
SSC11815,Gunningbland,872,45,35,80,59,1062,0,4,0,0,7,3,23,38,38,0
SSC11817,Gurley,873,127,106,233,187,1275,0,27,0,3,14,16,38,137,130,7
SSC11822,Guyra,874,981,1049,2030,1603,948,0,238,21,12,104,79,346,847,799,48
SSC11823,Gwabegar,875,76,80,156,130,739,0,22,0,0,7,0,19,52,41,11
SSC11824,Gwandalan,876,1666,1607,3273,2683,1258,400,219,22,28,157,197,850,1488,1387,101
SSC11825,Gwynneville,877,1661,1438,3099,2619,998,0,175,298,45,506,206,340,1365,1150,215
SSC11826,Gymea,878,3677,3907,7584,6231,1763,640,498,250,112,999,745,1436,4136,3976,160
SSC11827,Gymea Bay,879,3368,3527,6895,5367,2523,0,365,317,113,986,635,1155,3675,3565,110
SSC11828,Haberfield,880,3197,3257,6454,5249,2164,800,456,480,116,1161,463,623,3178,3050,128
SSC11830,Halekulani,881,1219,1317,2536,2130,852,410,238,12,12,112,168,584,1004,903,101
SSC11831,Halfway Creek,882,135,122,257,197,887,0,26,0,0,14,9,61,103,80,23
SSC11832,Hallidays Point,883,264,258,522,426,1210,0,38,7,8,58,47,123,237,228,9
SSC11833,Halloran,884,22,24,46,38,1562,0,8,0,0,0,4,8,16,16,0
SSC11838,Hamilton,885,2033,2199,4232,3732,1360,485,384,231,105,779,335,646,2393,2223,170
SSC11839,Hamilton East,886,502,489,991,794,1792,0,64,70,26,194,77,108,500,469,31
SSC11840,Hamilton North,887,430,445,875,715,1452,0,45,36,13,112,66,189,493,466,27
SSC11841,Hamilton South,888,1955,1920,3875,3200,1028,0,376,160,85,584,242,530,1678,1541,137
SSC11842,Hamilton Valley,889,285,284,569,442,1472,0,44,5,11,44,34,137,312,292,20
SSC11843,Hamlyn Terrace,890,2885,3188,6073,4631,1553,0,476,82,48,375,444,1146,2717,2541,176
SSC11844,Hammondville,891,1654,1837,3491,2788,1580,0,217,82,34,297,260,609,1553,1475,78
SSC11846,Hampton,892,56,50,106,98,1166,0,17,9,3,15,8,16,49,49,0
SSC11849,Hannam Vale,893,89,91,180,156,1087,0,18,6,9,16,19,37,81,77,4
SSC11850,Hanwood,894,656,603,1259,1023,1461,0,143,8,11,79,53,222,687,654,33
SSC11851,Harden,895,952,1082,2034,1700,829,0,265,12,14,88,107,338,746,706,40
SSC11852,Hardys Bay,896,112,120,232,199,1271,0,25,17,4,41,25,34,100,97,3
SSC11853,Harefield,897,73,69,142,111,1812,0,12,3,0,24,14,18,86,86,0
SSC11857,Harpers Hill,898,27,24,51,48,1062,0,3,0,0,11,3,13,13,13,0
SSC11858,Harrington,899,1501,1535,3036,2738,784,0,342,19,21,157,198,717,857,759,98
SSC11859,Harrington Park,900,5224,5442,10666,7831,2416,550,531,255,135,988,918,1756,5771,5519,252
SSC11860,Harris Park,901,3110,2692,5802,4776,1509,0,672,736,80,1301,422,300,3002,2731,271
SSC11861,Hartley,902,219,195,414,349,1647,0,38,12,5,46,37,98,224,211,13
SSC11862,Hartley Vale,903,32,31,63,63,1875,0,15,0,3,8,3,17,41,38,3
SSC11865,Harwood,904,152,141,293,250,825,0,33,0,8,19,13,83,130,119,11
SSC11866,Hassall Grove,905,2207,2299,4506,3414,1718,400,304,87,25,395,292,654,2296,2139,157
SSC11868,Hastings Point,906,298,356,654,612,723,0,85,11,7,36,38,142,169,152,17
SSC11871,Havilah,907,7,13,20,22,1625,0,3,3,0,3,0,4,15,15,0
SSC11872,Hawkesbury Heights,908,220,230,450,352,2270,0,21,19,14,33,51,86,245,242,3
SSC11873,Hawks Nest,909,626,593,1219,1080,874,340,139,23,24,109,86,290,401,359,42
SSC11877,Haymarket,910,3536,3815,7351,7059,1505,0,1439,546,46,1765,786,328,4036,3663,373
SSC11880,Haywards Bay,911,493,510,1003,751,2060,0,42,22,9,82,83,227,533,515,18
SSC11881,Hazelbrook,912,2334,2645,4979,3879,1496,425,237,210,125,645,491,926,2446,2345,101
SSC11883,Heathcote,913,2896,3116,6012,4860,1864,600,382,173,94,570,516,1313,3072,2957,115
SSC11884,Heatherbrae,914,282,226,508,471,841,0,63,5,3,23,18,113,204,181,23
SSC11886,Hebersham,915,2805,2880,5685,4308,1237,340,543,71,22,295,274,774,2286,2050,236
SSC11887,Heckenberg,916,1454,1636,3090,2360,968,0,432,21,13,113,166,371,1004,873,131
SSC11888,Heddon Greta,917,1019,1034,2053,1602,1780,0,89,20,10,102,125,492,1097,1028,69
SSC11890,Helensburgh,918,3210,3173,6383,4934,2111,580,496,192,96,638,522,1319,3486,3356,130
SSC11891,Henley,919,238,228,466,400,3035,0,42,32,13,112,38,48,242,239,3
SSC11892,Henty,920,615,621,1236,964,810,0,116,8,12,54,72,213,451,426,25
SSC11894,Hermidale,921,77,60,137,110,1375,0,19,0,0,7,7,25,66,66,0
SSC11895,Hermitage Flat,922,164,176,340,297,791,0,40,6,4,17,13,83,134,115,19
SSC11897,Herons Creek,923,128,119,247,197,1187,0,21,3,0,9,24,66,120,110,10
SSC11898,Hexham,924,70,62,132,112,916,0,8,0,0,0,3,20,45,42,3
SSC11903,Hill End,925,58,46,104,91,587,0,13,0,3,7,12,25,35,35,0
SSC11905,Hill Top,926,1362,1315,2677,2028,1551,450,187,27,23,122,156,611,1353,1291,62
SSC11906,Hilldale,927,106,89,195,160,1228,0,26,0,3,13,17,44,96,89,7
SSC11909,Hillsborough,928,323,334,657,530,1542,0,27,3,8,62,54,151,326,306,20
SSC11911,Hillsdale,929,2746,2760,5506,4515,1337,0,632,302,47,708,402,673,2811,2625,186
SSC11914,Hillvue,930,3094,3296,6390,5096,1471,0,471,101,60,491,470,1315,3268,3132,136
SSC11915,Hinchinbrook,931,5554,5668,11222,8822,1790,480,895,172,55,923,855,1587,5500,5060,440
SSC11917,Hobartville,932,1333,1416,2749,2160,1411,0,184,70,21,177,202,540,1385,1311,74
SSC11919,Hogarth Range,933,31,16,47,37,1031,0,3,0,0,7,3,4,25,25,0
SSC11920,Holbrook,934,826,888,1714,1394,991,0,209,17,14,103,111,281,702,671,31
SSC11921,Holgate,935,512,454,966,763,2602,0,57,61,18,144,84,143,486,470,16
SSC11924,Holmesville,936,688,682,1370,1097,1366,0,98,14,3,49,62,335,650,605,45
SSC11925,Holroyd,937,673,608,1281,1007,1860,0,127,106,11,247,97,102,680,628,52
SSC11926,Holsworthy,938,2954,2527,5481,4245,2172,500,379,310,69,781,421,835,3147,3004,143
SSC11929,Homebush,939,3739,3270,7009,6003,1810,620,672,767,117,1559,511,516,3928,3634,294
SSC11930,Homebush West,940,4522,4088,8610,7234,1635,0,1132,964,104,1784,620,477,4582,4201,381
SSC11935,Horningsea Park,941,1805,1926,3731,2761,2084,530,200,88,23,384,265,541,1899,1807,92
SSC11936,Hornsby,942,10860,11307,22167,18054,1696,590,1537,2234,460,4702,1886,2069,11931,11198,733
SSC11937,Hornsby Heights,943,3104,3199,6303,4915,2273,0,296,419,134,1108,568,859,3435,3292,143
SSC11941,Horsfield Bay,944,273,272,545,459,1937,0,58,25,13,70,49,94,283,268,15
SSC11942,Horsley,945,4012,4215,8227,6233,1826,490,450,157,83,585,679,1780,4256,4049,207
SSC11943,Horsley Park,946,949,887,1836,1520,1720,400,212,24,4,114,102,291,857,827,30
SSC11950,Howlong,947,1385,1389,2774,2274,1024,0,325,22,33,146,134,533,1124,1069,55
SSC11951,Hoxton Park,948,2146,2211,4357,3293,1725,500,373,94,16,333,307,567,2033,1910,123
SSC11954,Hunters Hill,949,4785,4740,9525,7625,2700,1000,913,834,205,1891,679,693,4226,4083,143
SSC11955,Hunterview,950,1476,1530,3006,2196,2113,0,165,46,28,217,175,692,1613,1505,108
SSC11958,Huntley,951,85,68,153,128,1958,0,17,6,4,18,15,37,96,96,0
SSC11960,Huntleys Cove,952,355,394,749,654,2071,0,59,65,21,174,79,74,390,380,10
SSC11961,Huntleys Point,953,72,72,144,130,3250,0,14,9,3,49,14,16,81,74,7
SSC11963,Hurlstone Park,954,2250,2448,4698,3960,1780,0,430,347,123,792,364,508,2494,2372,122
SSC11964,Hurstville,955,14660,15165,29825,25635,1382,580,2507,3046,306,5715,2267,2001,14992,13522,1470
SSC11965,Hurstville Grove,956,1321,1343,2664,2228,2094,645,186,161,37,472,226,333,1386,1315,71
SSC11966,Huskisson,957,380,407,787,727,864,420,99,16,21,75,73,159,329,310,19
SSC11967,Hyams Beach,958,54,56,110,109,1156,0,3,19,5,21,8,26,36,36,0
SSC11970,Ilarwill,959,117,103,220,191,949,0,25,3,3,18,18,58,91,86,5
SSC11974,Illawong,960,3642,3629,7271,6075,2466,775,326,329,112,1173,671,1297,4154,4009,145
SSC11975,Iluka,961,870,846,1716,1533,723,400,232,12,12,77,113,363,419,381,38
SSC11978,Ingleburn,962,7483,7554,15037,11945,1401,415,1209,624,134,1600,1039,2243,7321,6699,622
SSC11979,Ingleside,963,511,462,973,816,2170,0,94,30,17,119,80,200,513,502,11
SSC11981,Inverell,964,5590,6070,11660,9290,971,310,1199,70,90,711,571,2208,4907,4536,371
SSC11990,Islington,965,940,944,1884,1605,1354,0,149,98,35,345,165,323,1107,1024,83
SSC11992,Jackadgery,966,50,45,95,71,1083,0,17,0,0,8,6,15,40,40,0
SSC11995,Jacky Bulbin Flat,967,12,16,28,21,537,0,3,0,0,0,4,9,3,3,0
SSC11998,Jamberoo,968,788,843,1631,1381,1703,0,140,75,50,256,160,321,786,758,28
SSC12000,Jamisontown,969,2645,2859,5504,4408,1385,435,456,109,55,372,366,1085,2780,2635,145
SSC12001,Jannali,970,3002,3184,6186,4865,1784,580,440,242,118,798,585,1025,3127,2985,142
SSC12004,Jeir,971,121,136,257,205,2963,0,20,12,4,50,13,28,143,143,0
SSC12005,Jellat Jellat,972,31,44,75,69,1333,0,9,0,3,10,14,11,43,40,3
SSC12009,Jenolan,973,10,13,23,13,0,0,4,0,0,0,0,3,8,8,0
SSC12014,Jerilderie,974,532,495,1027,850,1110,0,150,7,9,61,56,163,452,431,21
SSC12016,Jerrabomberra,975,4763,4745,9508,7225,2820,640,375,653,294,1203,872,1272,5655,5469,186
SSC12017,Jerrara,976,72,80,152,116,2349,0,19,6,3,28,3,22,63,60,3
SSC12018,Jerrawa,977,38,37,75,59,1312,0,8,0,0,8,10,11,37,32,5
SSC12021,Jerrys Plains,978,198,188,386,303,1525,0,45,0,0,32,23,99,201,198,3
SSC12023,Jesmond,979,1537,1511,3048,2506,850,390,264,167,30,318,161,364,1163,958,205
SSC12024,Jewells,980,1180,1228,2408,1983,1492,0,132,24,45,246,183,587,1178,1117,61
SSC12027,Jilliby,981,814,829,1643,1313,2161,600,145,37,16,167,139,331,857,836,21
SSC12030,Jindabyne,982,1418,1216,2634,2212,1450,0,298,72,35,290,209,611,1650,1619,31
SSC12032,Jindera,983,1106,1112,2218,1656,1492,0,184,29,29,157,142,495,1093,1042,51
SSC12033,Jingellic,984,31,31,62,61,900,0,9,3,0,6,4,10,32,32,0
SSC12037,Johns River,985,165,161,326,282,942,0,72,4,4,18,21,73,134,122,12
SSC12042,Jordan Springs,986,2531,2628,5159,3781,2231,0,224,252,57,618,455,794,2937,2823,114
SSC12044,Jugiong,987,115,105,220,190,1268,0,21,3,0,12,13,41,119,116,3
SSC12045,Junction Hill,988,684,686,1370,1131,1167,0,96,26,16,119,101,286,569,536,33
SSC12046,Junee,989,2881,2038,4919,4110,1078,270,1362,24,23,183,196,787,1726,1624,102
SSC12048,Kahibah,990,1184,1285,2469,1954,1435,0,133,54,47,336,185,510,1239,1170,69
SSC12051,Kalaru,991,361,347,708,537,1257,0,75,25,23,67,37,124,311,297,14
SSC12053,Kamarah,992,48,48,96,78,1218,0,12,0,0,0,3,19,42,42,0
SSC12055,Kanahooka,993,2640,2937,5577,4655,1212,0,386,79,64,371,404,1267,2354,2220,134
SSC12057,Kandos,994,671,647,1318,1123,698,0,206,7,3,37,49,245,376,315,61
SSC12058,Kangaloon,995,75,71,146,118,2150,0,17,6,0,16,10,20,66,63,3
SSC12061,Kangaroo Valley,996,439,440,879,759,1255,0,112,48,20,125,63,145,411,401,10
SSC12064,Kangy Angy,997,162,147,309,258,1093,0,29,5,0,19,21,58,147,133,14
SSC12067,Kanwal,998,1932,2167,4099,3378,1097,390,697,20,25,196,243,750,1603,1454,149
SSC12068,Kapooka,999,422,208,630,574,2173,0,106,4,8,35,30,147,441,441,0
SSC12070,Karaak Flat,1000,26,23,49,39,1062,0,3,0,0,0,0,14,17,17,0
SSC12071,Karabar,1001,4073,4172,8245,6625,1692,480,644,197,127,584,553,1478,4392,4184,208
SSC12073,Kareela,1002,1722,1729,3451,2750,2273,0,163,174,63,504,359,558,1752,1684,68
SSC12074,Kariong,1003,3239,3143,6382,4975,1813,430,516,109,60,511,545,1275,3371,3156,215
SSC12076,Karuah,1004,742,670,1412,1191,795,340,186,20,10,37,61,287,492,443,49
SSC12077,Katoomba,1005,3787,4180,7967,6727,976,415,817,429,191,1098,736,1296,3695,3433,262
SSC12079,Kearns,1006,1397,1351,2748,2194,2039,0,157,49,21,207,201,539,1625,1566,59
SSC12080,Kearsley,1007,457,401,858,650,1260,0,59,4,0,24,30,206,383,352,31
SSC12081,Keepit,1008,7,3,10,13,900,0,0,0,0,0,0,6,8,8,0
SSC12083,Keerrong,1009,78,79,157,116,1166,0,20,3,0,10,14,22,64,55,9
SSC12085,Keiraville,1010,1778,1789,3567,3079,1296,580,160,346,70,628,227,432,1665,1466,199
SSC12088,Kellyville,1011,13767,14205,27972,21162,2564,644,1346,1738,433,4698,2417,3373,15280,14600,680
SSC12089,Kellyville Ridge,1012,5155,5320,10475,7377,2559,610,470,622,152,1702,827,1229,5623,5371,252
SSC12090,Kelso,1013,4389,4583,8972,6816,1445,0,702,125,124,702,544,1728,4146,3890,256
SSC12092,Kembla Grange,1014,124,129,253,200,1895,470,24,8,3,23,17,62,110,110,0
SSC12093,Kembla Heights,1015,61,62,123,84,1208,0,17,0,0,9,9,13,56,49,7
SSC12094,Kemps Creek,1016,1142,1127,2269,1866,1613,480,340,22,8,120,113,424,1048,976,72
SSC12095,Kempsey,1017,259,217,476,398,712,265,63,5,0,13,24,91,168,140,28
SSC12096,Kendall,1018,555,591,1146,900,1061,0,113,7,12,65,77,252,446,410,36
SSC12099,Kensington,1019,7537,7466,15003,13525,1646,950,1413,1555,203,3263,896,945,7366,6584,782
SSC12100,Kenthurst,1020,2540,2500,5040,4061,2604,460,281,211,85,751,448,848,2699,2606,93
SSC12101,Kentlyn,1021,375,368,743,594,2050,0,59,16,13,96,45,132,360,338,22
SSC12102,Kentucky,1022,76,83,159,142,1187,0,19,8,3,19,11,24,84,84,0
SSC12103,Kentucky South,1023,65,61,126,98,788,0,11,0,3,11,17,30,64,61,3
SSC12106,Kerrabee,1024,9,3,12,15,1649,0,6,0,0,3,0,0,5,5,0
SSC12108,Kerrs Creek,1025,26,20,46,37,1031,0,6,0,0,3,12,8,21,21,0
SSC12111,Khancoban,1026,152,151,303,258,914,0,34,6,5,17,22,57,108,97,11
SSC12116,Kiama,1027,3350,3531,6881,5874,1306,550,595,278,154,912,682,1258,3016,2865,151
SSC12117,Kiama Downs,1028,2486,2517,5003,4037,1836,540,271,172,127,669,487,1031,2496,2372,124
SSC12118,Kiama Heights,1029,413,399,812,696,1581,0,62,43,22,111,85,157,383,361,22
SSC12119,Kianga,1030,375,403,778,692,873,0,113,7,11,63,59,168,244,229,15
SSC12120,Kiar,1031,14,17,31,30,1624,0,4,0,0,0,3,3,15,15,0
SSC12125,Kilaben Bay,1032,691,740,1431,1157,1798,0,85,62,26,162,138,297,698,652,46
SSC12127,Kilgra,1033,41,38,79,66,739,0,9,0,0,0,6,13,28,28,0
SSC12129,Killara,1034,5025,5550,10575,8553,2534,1100,627,1381,243,2700,738,488,5126,4831,295
SSC12130,Killarney Heights,1035,2157,2310,4467,3421,2590,975,200,361,100,866,386,378,2171,2080,91
SSC12131,Killarney Vale,1036,3424,3791,7215,5773,1222,420,701,61,47,388,483,1587,3246,3021,225
SSC12132,Killawarra,1037,92,85,177,139,1062,0,24,0,0,14,13,32,72,72,0
SSC12133,Killcare,1038,228,249,477,385,1316,0,41,14,11,79,46,76,219,207,12
SSC12134,Killcare Heights,1039,368,375,743,611,1592,0,36,36,33,122,87,120,350,333,17
SSC12136,Killimicat,1040,12,15,27,26,1875,0,0,0,0,5,7,3,22,22,0
SSC12137,Killingworth,1041,357,326,683,544,1757,0,26,9,0,37,44,183,386,361,25
SSC12140,Kinchela,1042,136,133,269,234,1055,0,27,0,0,19,21,66,120,110,10
SSC12141,Kincumber,1043,3239,3855,7094,5904,1082,490,558,144,93,624,547,1470,3023,2839,184
SSC12142,Kincumber South,1044,310,379,689,641,645,0,75,8,6,54,59,128,178,167,11
SSC12145,King Creek,1045,780,790,1570,1254,1582,0,136,27,30,160,145,340,754,715,39
SSC12146,Kingfisher Shores,1046,84,84,168,134,1275,0,7,8,0,17,11,48,81,76,5
SSC12149,Kings Langley,1047,4660,4690,9350,7432,2114,520,570,382,174,1213,816,1549,5040,4830,210
SSC12150,Kings Park,1048,1731,1721,3452,2643,1904,440,184,107,41,406,294,644,1880,1796,84
SSC12153,Kings Point,1049,256,294,550,455,1076,0,32,12,5,38,35,140,255,244,11
SSC12154,Kingscliff,1050,3567,3890,7457,6194,1230,640,839,212,134,849,634,1281,3308,3108,200
SSC12156,Kingsford,1051,7907,7574,15481,13731,1374,800,1203,1637,214,3704,890,1085,7062,6316,746
SSC12158,Kingsgrove,1052,6071,6378,12449,10203,1564,600,984,455,121,1606,994,1544,5875,5521,354
SSC12161,Kingsvale,1053,87,92,179,138,1136,0,13,3,0,21,11,26,75,68,7
SSC12163,Kingswood,1054,4573,4727,9300,7369,1229,370,909,310,91,779,567,1523,4329,3960,369
SSC12165,Kioloa,1055,147,118,265,235,767,0,22,3,0,14,28,66,93,87,6
SSC12171,Kirkham,1056,349,345,694,552,2942,0,43,18,7,98,52,105,396,389,7
SSC12172,Kirrawee,1057,4420,4862,9282,7471,1709,590,688,340,143,1163,872,1692,4691,4521,170
SSC12173,Kirribilli,1058,1814,2008,3822,3544,2233,980,462,547,113,1226,298,227,2325,2226,99
SSC12176,Klori,1059,26,26,52,44,1749,0,3,0,0,3,4,6,25,25,0
SSC12178,Knockrow,1060,107,92,199,166,1218,0,31,6,4,27,17,30,88,79,9
SSC12181,Kogarah,1061,7588,7534,15122,12699,1626,583,1259,1401,191,3127,1205,1349,8414,7794,620
SSC12182,Kogarah Bay,1062,998,1020,2018,1643,2051,550,149,97,17,306,166,274,991,950,41
SSC12185,Koolewong,1063,436,429,865,736,1504,420,57,40,21,112,91,179,445,416,29
SSC12186,Koolkhan,1064,24,15,39,31,1024,0,6,0,0,0,0,6,14,14,0
SSC12187,Koonawarra,1065,1779,1885,3664,2885,1038,0,267,21,19,119,187,723,1518,1328,190
SSC12188,Koonorigan,1066,156,149,305,251,1069,0,22,6,5,41,31,56,157,147,10
SSC12192,Koorawatha,1067,225,200,425,360,781,0,65,6,4,20,23,61,145,135,10
SSC12193,Kooringal,1068,3564,3662,7226,5745,1196,0,558,186,101,687,484,1417,3519,3303,216
SSC12194,Kootingal,1069,1021,1108,2129,1652,1237,0,155,25,21,131,120,484,1020,972,48
SSC12195,Koraleigh,1070,185,169,354,291,857,0,38,0,0,6,10,60,163,149,14
SSC12197,Korora,1071,1218,1272,2490,2012,1436,503,207,82,60,322,238,471,1196,1140,56
SSC12200,Kotara,1072,1929,1999,3928,3127,1638,480,203,146,65,554,371,730,1995,1892,103
SSC12201,Kotara South,1073,532,570,1102,854,1421,0,71,37,25,137,92,193,530,499,31
SSC12202,Krambach,1074,200,184,384,321,821,0,54,4,3,22,22,85,156,142,14
SSC12206,Kulnura,1075,313,294,607,510,1544,0,65,14,5,44,48,116,313,303,10
SSC12209,Kundabung,1076,312,316,628,505,1366,0,87,5,3,47,43,147,254,240,14
SSC12212,Kungala,1077,77,68,145,130,1145,0,18,4,0,4,19,37,59,52,7
SSC12213,Kunghur,1078,62,46,108,88,924,0,7,0,0,5,13,22,45,45,0
SSC12215,Kurmond,1079,430,420,850,693,1723,0,69,11,10,88,72,173,432,418,14
SSC12216,Kurnell,1080,1148,1121,2269,1694,1898,588,156,26,14,138,158,518,1147,1101,46
SSC12217,Kurraba Point,1081,719,803,1522,1326,2856,0,130,212,42,483,125,83,921,889,32
SSC12218,Kurrajong,1082,1519,1540,3059,2522,2005,0,227,101,53,341,272,667,1661,1600,61
SSC12219,Kurrajong Heights,1083,656,681,1337,1093,2042,450,118,44,31,153,149,257,714,694,20
SSC12220,Kurrajong Hills,1084,316,352,668,541,2277,0,52,27,18,82,69,120,358,343,15
SSC12221,Kurri Kurri,1085,2963,3076,6039,4962,991,330,626,34,25,198,251,1357,2512,2263,249
SSC12222,Kyalite,1086,47,33,80,68,1025,0,5,0,0,3,5,18,47,47,0
SSC12226,Kyeemagh,1087,446,470,916,761,1395,670,113,17,3,95,79,131,408,392,16
SSC12227,Kyle Bay,1088,512,524,1036,836,2511,0,78,36,10,223,86,110,532,503,29
SSC12229,Kyogle,1089,1049,1151,2200,1815,814,315,307,9,16,110,120,377,734,662,72
SSC12230,La Perouse,1090,198,203,401,337,1531,0,39,14,3,39,20,58,167,159,8
SSC12234,Laffing Waters,1091,46,62,108,97,1958,0,5,3,0,17,18,23,51,51,0
SSC12235,Laggan,1092,190,170,360,288,1509,0,29,4,3,32,25,66,189,185,4
SSC12237,Laguna,1093,114,103,217,178,1156,0,37,4,0,34,23,28,79,67,12
SSC12238,Lake Albert,1094,3005,3187,6192,4929,1553,0,363,163,102,630,444,1319,3141,3038,103
SSC12239,Lake Bathurst,1095,130,100,230,204,1649,0,36,12,4,28,13,41,93,87,6
SSC12242,Lake Cargelligo,1096,728,748,1476,1145,1048,0,195,8,13,54,62,194,583,541,42
SSC12243,Lake Cathie,1097,1701,1793,3494,2906,1034,0,268,43,40,285,296,789,1395,1300,95
SSC12244,Lake Conjola,1098,235,205,440,399,789,0,58,6,10,13,22,133,130,125,5
SSC12245,Lake Cowal,1099,23,19,42,29,1624,0,0,0,0,4,0,14,29,29,0
SSC12246,Lake George,1100,50,49,99,82,2625,0,7,11,0,14,12,20,56,56,0
SSC12247,Lake Haven,1101,1633,1945,3578,3077,866,0,514,32,10,137,171,650,1301,1164,137
SSC12248,Lake Heights,1102,1915,1930,3845,3094,1092,433,364,42,19,233,244,724,1605,1464,141
SSC12250,Lake Illawarra,1103,1528,1638,3166,2671,898,0,299,44,33,150,169,677,1320,1191,129
SSC12253,Lake Munmorah,1104,2543,2699,5242,4401,1004,380,493,41,35,264,344,1222,2160,1998,162
SSC12254,Lake Tabourie,1105,330,322,652,537,852,0,65,8,6,33,48,165,258,232,26
SSC12257,Lakemba,1106,9196,7827,17023,12734,1012,500,1886,1119,139,2109,890,1157,6553,5669,884
SSC12258,Lakesland,1107,214,217,431,352,2125,0,41,12,6,32,23,83,225,211,14
SSC12259,Lakewood,1108,584,606,1190,1008,824,0,116,23,13,60,71,275,344,313,31
SSC12261,Lalor Park,1109,3808,3857,7665,6189,1251,380,769,173,46,630,514,1267,3573,3314,259
SSC12264,Lambton,1110,2340,2567,4907,3974,1341,450,302,212,88,682,343,843,2516,2373,143
SSC12266,Lane Cove,1111,5142,5675,10817,8783,2192,925,639,1266,306,2656,889,836,6008,5741,267
SSC12267,Lane Cove North,1112,5525,5916,11441,9468,2161,820,823,1367,294,2974,999,914,6850,6553,297
SSC12268,Lane Cove West,1113,1301,1329,2630,2020,2567,0,126,279,62,627,186,200,1405,1334,71
SSC12269,Langley Vale,1114,23,22,45,40,675,0,6,0,0,0,0,13,7,7,0
SSC12270,Lanitza,1115,159,137,296,243,1021,0,34,0,3,15,14,56,119,103,16
SSC12272,Lansdowne,1116,10,7,17,17,1874,0,3,0,0,0,0,3,12,12,0
SSC12275,Lansvale,1117,1352,1221,2573,2106,1330,500,287,28,11,192,163,330,1091,992,99
SSC12276,Lapstone,1118,487,472,959,785,2115,0,70,68,33,149,98,130,474,465,9
SSC12278,Largs,1119,946,989,1935,1466,1727,0,145,29,18,170,126,422,971,931,40
SSC12281,Laughtondale,1120,49,37,86,74,1406,0,10,0,0,7,3,27,42,42,0
SSC12282,Laurel Hill,1121,7,12,19,20,1087,0,3,0,0,0,0,5,6,6,0
SSC12283,Laurieton,1122,921,1063,1984,1811,716,360,284,20,21,106,116,380,474,413,61
SSC12285,Lavender Bay,1123,454,487,941,867,2277,0,102,161,14,304,70,68,570,550,20
SSC12287,Lavington,1124,6007,6461,12468,10295,933,305,1398,142,101,660,707,2613,5591,5079,512
SSC12289,Lawson,1125,1237,1380,2617,2134,1314,440,199,138,68,335,220,477,1306,1235,71
SSC12291,Leconfield,1126,75,66,141,117,1775,0,8,3,0,12,10,40,76,72,4
SSC12293,Leeton,1127,4234,4385,8619,6910,1207,310,1034,76,66,565,394,1529,3958,3751,207
SSC12297,Leichhardt,1128,7017,7611,14628,11780,2256,750,1237,1371,408,3304,1173,1263,8285,7952,333
SSC12299,Lemon Tree,1129,29,26,55,50,2083,0,11,3,0,4,6,11,33,33,0
SSC12300,Lemon Tree Passage,1130,1327,1274,2601,2191,983,385,273,17,19,137,188,641,975,888,87
SSC12303,Lennox Head,1131,3065,3338,6403,5152,1577,600,466,283,162,1059,546,1054,3354,3179,175
SSC12304,Leonay,1132,1235,1280,2515,1986,2153,498,166,94,45,266,245,469,1325,1278,47
SSC12305,Leppington,1133,1782,1710,3492,2758,1634,540,360,114,27,276,225,535,1639,1559,80
SSC12307,Lethbridge Park,1134,2311,2441,4752,3604,959,300,636,21,11,109,166,593,1606,1377,229
SSC12308,Leumeah,1135,4849,4985,9834,7864,1298,380,780,277,72,748,644,1797,4696,4331,365
SSC12309,Leura,1136,2225,2428,4653,4074,1164,450,632,333,126,724,490,618,1935,1818,117
SSC12313,Lewisham,1137,1529,1639,3168,2754,1974,700,319,313,120,720,251,292,1867,1753,114
SSC12316,Lidcombe,1138,10127,9498,19625,16752,1571,510,2102,1041,197,3349,1528,1497,9963,9121,842
SSC12318,Lidsdale,1139,231,197,428,354,1487,0,72,0,0,9,14,90,189,180,9
SSC12322,Lilli Pilli,1140,690,704,1394,1107,3297,870,54,97,24,232,145,203,771,750,21
SSC12323,Lillian Rock,1141,103,120,223,183,706,0,29,7,5,27,27,33,79,71,8
SSC12325,Lilyfield,1142,3618,3996,7614,5994,2310,793,594,718,214,1533,498,638,4009,3836,173
SSC12327,Limbri,1143,53,51,104,99,966,0,16,0,0,7,4,29,46,46,0
SSC12329,Limeburners Creek,1144,8,3,11,13,1375,0,0,0,0,0,3,8,6,6,0
SSC12330,Limekilns,1145,55,56,111,93,1531,0,4,3,6,12,8,23,60,60,0
SSC12335,Linden,1146,256,241,497,423,2045,0,26,25,12,95,58,86,280,254,26
SSC12336,Lindendale,1147,121,124,245,202,1786,0,15,8,8,35,24,59,133,133,0
SSC12339,Lindfield,1148,4742,5046,9788,7796,2513,935,551,1174,262,2516,681,498,4838,4629,209
SSC12341,Linley Point,1149,177,170,347,284,3692,0,18,37,4,78,26,16,197,186,11
SSC12343,Lisarow,1150,2519,2618,5137,4070,1742,520,290,131,72,536,437,1014,2656,2517,139
SSC12344,Lismore,1151,1744,1833,3577,3039,838,380,419,74,56,357,204,681,1512,1322,190
SSC12345,Lismore Heights,1152,1041,1152,2193,1766,1134,0,182,67,56,260,166,389,1063,986,77
SSC12346,Liston,1153,72,65,137,115,787,0,18,3,0,6,9,27,60,57,3
SSC12347,Lithgow,1154,2490,2711,5201,4417,834,300,569,58,47,309,277,1058,2079,1903,176
SSC12349,Little Bay,1155,2170,2306,4476,3684,2041,0,642,345,84,700,346,496,2132,2044,88
SSC12352,Little Hartley,1156,252,256,508,424,1388,0,48,18,5,52,51,123,275,264,11
SSC12355,Little Pelican,1157,3,0,3,4,0,0,0,0,0,0,0,0,4,4,0
SSC12356,Little Plain,1158,72,70,142,107,1156,0,7,0,0,11,11,34,76,76,0
SSC12361,Liverpool,1159,13455,13631,27086,21389,1089,430,4318,773,141,2346,1867,2902,9598,8499,1099
SSC12362,Llanarth,1160,1061,1138,2199,1702,2151,0,97,88,43,287,207,381,1161,1124,37
SSC12363,Llandilo,1161,830,806,1636,1280,1888,0,180,16,8,64,59,313,810,771,39
SSC12364,Llangothlin,1162,68,58,126,99,1166,0,12,0,0,9,12,23,61,61,0
SSC12365,Lloyd,1163,404,434,838,620,2005,0,50,12,16,88,59,184,470,459,11
SSC12368,Lochinvar,1164,390,393,783,660,1797,0,60,10,8,48,50,192,412,388,24
SSC12369,Lockhart,1165,528,540,1068,864,960,0,102,5,12,57,46,222,448,432,16
SSC12371,Loftus,1166,2011,2124,4135,3208,2083,630,173,155,73,522,375,768,2094,2030,64
SSC12372,Loftville,1167,146,83,229,205,486,0,45,0,3,4,8,47,69,52,17
SSC12375,Londonderry,1168,2016,1892,3908,3140,1862,550,378,42,18,148,192,872,2037,1965,72
SSC12377,Long Flat,1169,68,56,124,96,849,0,18,0,0,3,0,24,46,43,3
SSC12378,Long Jetty,1170,3057,3330,6387,5277,972,0,683,77,59,410,401,1267,2779,2561,218
SSC12381,Long Point,1171,112,92,204,175,1671,0,21,0,0,26,14,46,109,105,4
SSC12385,Longueville,1172,1031,1028,2059,1651,4050,0,96,260,49,588,130,113,1042,1009,33
SSC12387,Lord Howe Island,1173,192,191,383,327,1397,0,41,7,0,41,29,101,228,225,3
SSC12389,Lorn,1174,638,699,1337,1072,1527,0,89,63,29,193,121,223,691,663,28
SSC12395,Louth Park,1175,347,310,657,507,2694,0,30,17,12,73,62,119,390,362,28
SSC12396,Lovedale,1176,246,238,484,405,1775,0,36,23,0,67,63,97,256,247,9
SSC12409,Lower Mangrove,1177,42,27,69,62,1416,0,8,3,0,9,3,11,26,26,0
SSC12412,Lower Portland,1178,299,296,595,485,1569,0,83,14,9,32,41,134,302,290,12
SSC12419,Luddenham,1179,900,925,1825,1405,2234,650,159,34,5,132,128,341,985,961,24
SSC12420,Lue,1180,101,92,193,155,825,0,28,3,0,7,10,34,85,81,4
SSC12421,Lugarno,1181,2755,2853,5608,4627,2168,580,335,231,110,891,542,887,2909,2800,109
SSC12422,Lurnea,1182,4548,4765,9313,7071,1068,420,1158,103,29,505,529,1129,3158,2809,349
SSC12430,Macksville,1183,1231,1367,2598,2128,886,370,353,22,17,105,125,499,899,820,79
SSC12431,Maclean,1184,1234,1392,2626,2304,824,378,331,31,27,188,153,509,855,768,87
SSC12432,Macmasters Beach,1185,635,660,1295,1081,1755,0,76,56,38,232,133,209,641,617,24
SSC12433,Macquarie Fields,1186,6607,7110,13717,10586,1211,383,1304,534,70,1113,785,1823,5666,5063,603
SSC12434,Macquarie Hills,1187,1640,1668,3308,2552,1930,0,141,65,53,329,248,735,1828,1727,101
SSC12435,Macquarie Links,1188,687,675,1362,1068,2635,0,88,78,19,243,105,131,771,740,31
SSC12436,Macquarie Marshes,1189,3,0,3,3,0,0,0,0,0,0,0,0,0,0,0
SSC12437,Macquarie Park,1190,3906,4234,8140,7281,1631,0,771,1178,127,2200,584,443,4521,4018,503
SSC12439,Maddens Plains,1191,4,0,4,4,0,0,0,0,0,0,0,0,3,0,3
SSC12441,Magenta,1192,103,101,204,178,1968,0,9,9,5,32,30,31,95,92,3
SSC12443,Maianbar,1193,247,258,505,419,2055,0,19,31,9,85,53,96,303,293,10
SSC12444,Maimuru,1194,65,70,135,105,1303,0,10,3,0,7,5,31,76,73,3
SSC12445,Main Arm,1195,307,281,588,471,1006,0,92,15,11,75,43,97,263,244,19
SSC12448,Maison Dieu,1196,95,85,180,149,2091,0,22,0,0,12,5,35,87,84,3
SSC12449,Maitland,1197,902,981,1883,1609,1040,345,223,39,22,167,136,343,837,748,89
SSC12451,Maitland Vale,1198,76,63,139,105,2449,0,10,3,3,21,7,27,67,64,3
SSC12453,Malabar,1199,3518,1908,5426,4779,1471,1000,2033,220,48,502,268,542,1712,1629,83
SSC12455,Mallabula,1200,484,445,929,753,968,0,102,5,4,36,63,226,378,342,36
SSC12457,Mallanganee,1201,88,65,153,139,743,0,17,6,0,3,6,33,56,51,5
SSC12460,Maloneys Beach,1202,176,197,373,312,1018,0,31,0,3,26,29,89,139,133,6
SSC12461,Malua Bay,1203,971,962,1933,1627,1137,0,213,56,39,187,136,413,790,741,49
SSC12467,Mandurama,1204,185,172,357,302,949,0,60,6,3,29,30,59,157,147,10
SSC12468,Mangerton,1205,1466,1393,2859,2346,1671,0,244,188,71,467,225,431,1449,1335,114
SSC12469,Mangoola,1206,25,24,49,38,762,0,8,0,0,3,0,13,23,23,0
SSC12472,Mangrove Mountain,1207,361,353,714,578,1471,0,48,11,10,65,57,137,370,367,3
SSC12473,Manildra,1208,375,389,764,610,1264,0,101,3,3,30,32,151,353,334,19
SSC12474,Manilla,1209,1231,1316,2547,2096,837,0,357,13,9,90,125,435,884,800,84
SSC12475,Manly,1210,7889,7975,15864,13810,2449,1475,1780,1732,367,4468,1345,1234,9346,8978,368
SSC12476,Manly Vale,1211,3020,3147,6167,4965,1959,950,527,375,151,1209,568,764,3474,3327,147
SSC12477,Mannering Park,1212,1214,1253,2467,2017,1187,390,195,18,17,115,138,536,1130,1036,94
SSC12478,Manning Point,1213,132,116,248,225,686,0,45,4,3,11,11,50,57,45,12
SSC12482,Manyana,1214,275,249,524,466,947,0,58,15,3,44,34,145,212,194,18
SSC12484,Maraylya,1215,626,615,1241,962,2133,0,77,34,13,116,82,287,659,637,22
SSC12485,Marayong,1216,3806,3903,7709,6188,1408,390,569,266,53,810,546,1121,3665,3366,299
SSC12487,Marchmont,1217,106,124,230,171,2555,0,6,12,3,32,23,35,127,127,0
SSC12488,Mardi,1218,1776,1904,3680,2863,1637,0,321,71,35,348,255,672,1758,1640,118
SSC12492,Marks Point,1219,870,952,1822,1533,955,0,157,29,19,132,115,423,762,703,59
SSC12498,Marmong Point,1220,382,375,757,630,1575,0,51,24,9,85,64,177,392,369,23
SSC12500,Maroota,1221,313,309,622,475,1761,0,74,13,0,37,48,118,299,293,6
SSC12501,Maroubra,1222,14858,15829,30687,25712,1722,883,2815,2560,520,6058,2274,3079,15267,14446,821
SSC12502,Marrangaroo,1223,680,234,914,817,1861,0,472,3,3,37,35,105,250,243,7
SSC12503,Marrar,1224,193,176,369,288,1476,0,29,8,0,25,25,76,198,198,0
SSC12504,Marrickville,1225,13030,13556,26586,22811,1814,750,3025,2111,585,5405,1876,2461,14782,13960,822
SSC12505,Marsden Park,1226,543,461,1004,853,1161,550,150,17,5,75,45,152,450,432,18
SSC12506,Marsfield,1227,6335,6957,13292,11464,1641,695,1078,1620,233,3043,991,1057,6481,5988,493
SSC12511,Martins Creek,1228,183,202,385,303,1446,0,45,3,6,27,28,90,175,168,7
SSC12512,Martinsville,1229,186,180,366,315,1702,0,43,21,5,67,30,67,177,170,7
SSC12513,Marulan,1230,606,570,1176,925,1143,0,103,7,4,63,60,253,522,492,30
SSC12514,Maryland,1231,3795,3898,7693,6057,1501,0,384,151,76,557,490,1651,4003,3740,263
SSC12517,Maryvale,1232,99,98,197,154,1468,0,21,3,4,14,12,34,94,90,4
SSC12518,Maryville,1233,723,725,1448,1216,1503,0,88,84,48,263,121,248,824,779,45
SSC12519,Mascot,1234,7437,7334,14771,12808,1955,680,1350,1222,174,2924,1149,1560,8658,8209,449
SSC12520,Matcham,1235,503,484,987,772,2700,0,62,63,18,160,90,134,477,465,12
SSC12522,Mathoura,1236,466,472,938,785,840,0,107,5,4,33,44,189,388,365,23
SSC12523,Matong,1237,93,70,163,139,1291,0,30,0,4,12,8,24,74,71,3
SSC12524,Matraville,1238,4761,5044,9805,8066,1713,0,953,429,98,1200,743,1353,4808,4580,228
SSC12530,Mayfield,1239,4634,4673,9307,7867,1178,0,818,309,126,1135,673,1715,4778,4345,433
SSC12534,Mayfield East,1240,832,861,1693,1450,1319,0,124,85,18,268,121,312,933,861,72
SSC12536,Mayfield West,1241,1000,898,1898,1565,1310,0,123,53,20,191,133,397,966,895,71
SSC12538,Mays Hill,1242,401,368,769,600,1639,0,95,43,10,131,50,59,344,306,38
SSC12549,Meadow Flat,1243,155,158,313,240,1721,0,25,11,8,32,24,63,148,148,0
SSC12550,Meadowbank,1244,2180,2230,4410,3867,1704,0,213,738,99,1331,332,345,2931,2735,196
SSC12553,Medlow Bath,1245,302,312,614,538,1117,0,45,26,18,94,73,120,317,298,19
SSC12554,Medowie,1246,4776,4795,9571,7285,1762,470,711,125,93,614,847,2203,4731,4481,250
SSC12555,Medway,1247,61,63,124,92,1562,0,18,4,0,8,4,29,53,53,0
SSC12557,Megalong Valley,1248,81,69,150,123,1145,0,24,3,3,21,8,21,65,61,4
SSC12560,Melinga,1249,50,55,105,93,1399,0,12,0,0,5,4,19,44,41,3
SSC12563,Melrose Park,1250,801,777,1578,1215,2091,0,71,89,30,275,147,187,781,742,39
SSC12567,Menai,1251,5050,5254,10304,8221,2238,700,526,388,151,1366,977,1734,5963,5721,242
SSC12568,Menangle,1252,556,591,1147,997,1521,0,133,29,8,108,102,226,524,514,10
SSC12569,Menangle Park,1253,135,118,253,199,1462,0,20,3,0,8,22,48,121,108,13
SSC12570,Mendooran,1254,289,269,558,448,774,0,66,5,3,16,22,108,221,204,17
SSC12573,Merewether,1255,5469,5494,10963,9082,1830,563,684,672,252,2247,941,1563,6137,5882,255
SSC12574,Merewether Heights,1256,681,713,1394,1075,2173,0,119,85,37,273,125,178,659,641,18
SSC12575,Merimbula,1257,1691,1853,3544,3161,945,450,457,71,57,346,258,732,1524,1438,86
SSC12585,Merriwa,1258,868,894,1762,1412,1039,0,247,13,12,96,79,317,751,712,39
SSC12586,Merriwagga,1259,58,49,107,83,1025,0,16,0,3,5,10,10,57,57,0
SSC12587,Merrygoen,1260,65,49,114,104,1281,0,23,0,0,10,8,20,57,53,4
SSC12588,Merrylands,1261,15179,14472,29651,23339,1267,480,3137,1028,211,3179,2119,3157,12653,11389,1264
SSC12589,Merrylands West,1262,3165,3424,6589,5326,1123,500,796,178,53,588,439,811,2757,2506,251
SSC12590,Merungle Hill,1263,118,137,255,203,1211,0,55,4,4,11,19,38,113,110,3
SSC12592,Metford,1264,2261,2501,4762,3634,1217,0,311,40,32,268,286,988,2170,1957,213
SSC12598,Michelago,1265,282,276,558,436,2250,0,55,14,13,57,36,114,308,301,7
SSC12602,Middle Cove,1266,676,659,1335,1062,3250,0,81,129,35,325,94,79,667,636,31
SSC12603,Middle Dural,1267,525,486,1011,817,2576,0,86,41,11,137,91,170,519,500,19
SSC12607,Middleton Grange,1268,2560,2615,5175,3633,2124,520,413,159,33,597,408,618,2521,2401,120
SSC12612,Milbrodale,1269,54,65,119,93,1125,0,16,0,0,5,5,26,55,52,3
SSC12617,Miller,1270,1614,1626,3240,2535,739,400,544,20,5,73,142,334,903,763,140
SSC12618,Millers Forest,1271,178,156,334,287,1875,0,18,3,4,22,26,92,197,191,6
SSC12619,Millers Point,1272,754,727,1481,1411,3062,0,282,215,27,416,119,83,824,802,22
SSC12620,Millfield,1273,491,516,1007,782,1288,0,131,10,6,53,47,207,404,364,40
SSC12622,Millingandi,1274,228,222,450,403,770,0,58,7,6,41,22,94,158,155,3
SSC12623,Millthorpe,1275,607,646,1253,940,1597,0,96,44,31,154,92,210,609,585,24
SSC12625,Milperra,1276,1946,2005,3951,3158,1851,550,210,86,44,372,275,807,2011,1905,106
SSC12629,Milsons Point,1277,1049,1113,2162,1984,3107,0,258,351,63,709,180,85,1297,1254,43
SSC12630,Milton,1278,775,895,1670,1403,1110,0,298,31,38,142,114,312,590,569,21
SSC12633,Minchinbury,1279,2763,2857,5620,4414,2002,458,296,125,51,593,435,930,3060,2876,184
SSC12634,Mindaribba,1280,36,35,71,62,2250,0,3,0,4,4,14,17,48,48,0
SSC12638,Minmi,1281,378,366,744,571,1734,0,21,7,3,35,47,179,387,366,21
SSC12639,Minnamurra,1282,379,380,759,621,1508,640,58,30,18,93,65,169,334,323,11
SSC12640,Minnie Water,1283,133,104,237,198,919,0,24,12,6,16,17,50,79,74,5
SSC12641,Minore,1284,82,69,151,129,1517,0,9,0,0,15,7,36,82,78,4
SSC12642,Minto,1285,6175,6374,12549,9688,1383,405,1016,562,85,1129,790,1629,5765,5281,484
SSC12643,Minto Heights,1286,182,195,377,320,2374,0,43,12,3,36,32,73,194,191,3
SSC12645,Miranda,1287,7355,7930,15285,12496,1573,650,1315,581,185,1813,1329,2627,7592,7261,331
SSC12646,Mirannie,1288,34,36,70,58,1999,0,10,0,0,3,0,19,41,41,0
SSC12647,Mirrabooka,1289,361,370,731,602,1244,0,43,25,14,53,65,170,346,323,23
SSC12653,Mittagong,1290,2600,3168,5768,4870,1173,470,680,224,98,661,460,943,2497,2396,101
SSC12654,Moama,1291,2991,3170,6161,5078,1148,435,648,62,69,456,375,1119,2692,2584,108
SSC12655,Modanville,1292,318,307,625,507,1259,0,64,14,11,59,41,130,287,263,24
SSC12656,Mogareeka,1293,27,28,55,53,1125,0,7,0,0,9,6,16,22,22,0
SSC12660,Mogo,1294,164,164,328,266,938,0,59,0,0,17,16,71,137,120,17
SSC12669,Mollymook,1295,519,556,1075,938,1006,0,113,28,22,90,98,215,428,403,25
SSC12670,Mollymook Beach,1296,1183,1262,2445,2094,1026,0,247,63,51,273,202,519,935,886,49
SSC12671,Molong,1297,1241,1339,2580,2008,1168,0,235,31,21,189,164,481,1127,1083,44
SSC12672,Mona Vale,1298,5126,5546,10672,8772,2001,950,927,451,183,1680,1023,1702,5437,5279,158
SSC12681,Monivae,1299,21,12,33,24,1375,0,3,0,0,3,5,9,14,14,0
SSC12682,Monkerai,1300,30,36,66,51,900,0,3,0,0,6,8,17,30,30,0
SSC12683,Monteagle,1301,109,103,212,170,1149,0,15,3,0,20,4,33,110,104,6
SSC12684,Montecollum,1302,23,32,55,48,1291,0,5,3,0,15,10,14,29,29,0
SSC12685,Montefiores,1303,295,296,591,457,1125,0,78,6,0,34,30,115,236,227,9
SSC12686,Monterey,1304,2171,2361,4532,3726,1498,650,400,196,46,633,381,607,2252,2147,105
SSC12687,Mooball,1305,101,94,195,152,1083,0,33,5,0,12,12,41,79,71,8
SSC12697,Moonan Flat,1306,70,59,129,112,1020,0,23,0,0,9,9,32,59,59,0
SSC12699,Moonbi,1307,529,597,1126,933,1064,0,149,4,7,62,66,226,458,438,20
SSC12703,Moonee Beach,1308,970,965,1935,1483,1562,0,131,36,31,182,153,405,919,863,56
SSC12704,Mooney Mooney,1309,157,145,302,270,2031,0,20,13,3,46,29,73,181,174,7
SSC12710,Moore Creek,1310,1197,1177,2374,1716,2109,0,146,56,35,229,185,499,1245,1214,31
SSC12711,Moore Park,1311,16,14,30,25,2249,0,18,0,0,0,3,0,12,12,0
SSC12712,Moorebank,1312,4831,4914,9745,7366,1889,580,591,310,79,1077,730,1541,4764,4524,240
SSC12714,Moorland,1313,265,229,494,409,922,0,66,7,4,23,28,110,200,175,25
SSC12715,Moorong,1314,81,96,177,114,2399,0,14,3,3,26,8,21,79,76,3
SSC12723,Morisset,1315,1530,1689,3219,2855,799,395,467,62,17,196,189,657,950,849,101
SSC12724,Morisset Park,1316,354,386,740,583,1612,0,50,23,14,76,57,174,340,323,17
SSC12725,Morning Bay,1317,17,20,37,39,2249,0,12,6,0,4,0,0,15,15,0
SSC12726,Mororo,1318,40,47,87,68,1625,0,4,3,5,10,6,19,48,45,3
SSC12727,Morpeth,1319,636,761,1397,1175,1111,0,89,46,29,152,130,278,631,601,30
SSC12728,Mortdale,1320,5044,5376,10420,8615,1731,600,768,684,145,1721,839,1342,5697,5406,291
SSC12729,Mortlake,1321,499,566,1065,892,2228,0,112,90,16,205,101,126,616,594,22
SSC12732,Morts Estate,1322,318,305,623,506,931,0,62,3,3,20,35,125,259,230,29
SSC12734,Moruya,1323,1990,1990,3980,3391,873,380,475,52,48,269,250,841,1580,1480,100
SSC12738,Mosman,1324,13189,15290,28479,23461,2522,1563,2460,3317,723,7415,2308,1632,14566,13999,567
SSC12739,Moss Vale,1325,4153,4422,8575,6993,1228,460,750,218,138,782,617,1634,3859,3714,145
SSC12741,Mossy Point,1326,283,286,569,478,1380,0,33,18,34,75,51,122,261,252,9
SSC12745,Mount Annan,1327,5711,5997,11708,8716,2214,460,479,282,131,1076,948,2112,6563,6261,302
SSC12749,Mount Burrell,1328,109,108,217,185,665,0,35,3,3,18,23,40,85,72,13
SSC12750,Mount Colah,1329,3532,3561,7093,5626,2268,595,329,364,168,1156,660,1185,4026,3873,153
SSC12756,Mount Druitt,1330,8343,8385,16728,12486,1268,380,1365,627,105,1832,1083,1945,6937,6202,735
SSC12758,Mount Fairy,1331,113,98,211,164,1875,0,15,11,4,24,29,26,108,105,3
SSC12760,Mount Frome,1332,72,62,134,110,1437,0,20,4,0,21,10,25,68,64,4
SSC12761,Mount George,1333,160,127,287,233,749,0,35,3,0,7,12,58,114,98,16
SSC12765,Mount Hunter,1334,354,379,733,568,2009,0,56,22,4,65,40,176,404,381,23
SSC12766,Mount Hutton,1335,1667,1858,3525,2973,1174,420,284,53,37,257,286,729,1584,1494,90
SSC12768,Mount Keira,1336,846,819,1665,1314,2100,0,91,110,45,269,132,259,854,814,40
SSC12769,Mount Kembla,1337,508,558,1066,842,2325,0,58,54,32,156,79,196,562,543,19
SSC12771,Mount Knowles,1338,20,19,39,30,1625,0,7,0,0,3,0,8,16,16,0
SSC12773,Mount Lambie,1339,44,37,81,64,1583,0,14,0,0,10,5,13,40,40,0
SSC12774,Mount Lewis,1340,575,620,1195,967,1302,460,120,31,7,113,67,118,450,414,36
SSC12782,Mount Ousley,1341,826,773,1599,1291,1784,0,87,91,27,253,151,236,790,750,40
SSC12783,Mount Panorama,1342,58,58,116,97,2250,0,31,4,0,17,3,16,39,39,0
SSC12784,Mount Pleasant,1343,680,688,1368,1075,2258,0,80,135,37,247,95,175,686,659,27
SSC12785,Mount Pritchard,1344,4937,5018,9955,7822,1191,400,1109,108,37,613,580,1350,4047,3609,438
SSC12786,Mount Rankin,1345,200,183,383,309,1906,0,36,18,7,38,30,83,203,200,3
SSC12788,Mount Riverview,1346,1488,1539,3027,2385,1987,0,127,137,89,407,304,563,1574,1501,73
SSC12794,Mount Thorley,1347,37,28,65,56,2187,0,4,0,0,0,5,14,29,29,0
SSC12795,Mount Tomah,1348,46,32,78,66,1083,0,7,4,3,16,10,13,36,36,0
SSC12796,Mount Vernon,1349,618,577,1195,974,2565,0,134,26,7,114,70,229,639,621,18
SSC12797,Mount Victoria,1350,509,509,1018,840,1065,0,110,33,30,131,81,189,442,412,30
SSC12798,Mount View,1351,62,62,124,105,2150,0,43,9,0,11,15,16,51,51,0
SSC12799,Mount Vincent,1352,192,171,363,300,1875,0,28,10,10,40,27,93,181,175,6
SSC12800,Mount Warning,1353,54,43,97,92,487,0,22,0,0,7,8,24,30,20,10
SSC12801,Mount Warrigal,1354,2428,2476,4904,3998,1156,0,406,50,40,252,320,1041,1992,1790,202
SSC12803,Mount White,1355,95,83,178,164,954,0,16,0,0,16,10,50,100,97,3
SSC12812,Mudgee,1356,5333,5594,10927,8497,1256,390,1172,119,105,809,587,2212,4925,4640,285
SSC12813,Mulbring,1357,284,309,593,490,1454,0,51,16,5,42,51,148,268,256,12
SSC12814,Mulgoa,1358,951,949,1900,1521,2217,548,176,50,21,197,151,353,961,920,41
SSC12815,Mulgrave,1359,51,35,86,76,2062,0,10,0,0,3,6,24,50,50,0
SSC12820,Mullaley,1360,83,75,158,130,1024,0,14,0,0,12,13,28,83,72,11
SSC12822,Mullaway,1361,279,286,565,446,1228,0,57,12,11,57,47,118,251,234,17
SSC12826,Mullion Creek,1362,271,283,554,425,1795,0,43,6,3,53,25,138,278,270,8
SSC12828,Mullumbimby,1363,1652,1943,3595,2939,998,610,433,95,70,419,317,544,1497,1398,99
SSC12830,Mulwala,1364,1066,1098,2164,1821,1028,0,264,19,21,98,133,459,897,863,34
SSC12832,Mumbil,1365,147,147,294,233,710,0,49,5,0,5,11,49,97,83,14
SSC12836,Mummulgum,1366,50,43,93,67,966,0,3,0,0,3,3,19,48,42,6
SSC12837,Mundamia,1367,39,32,71,70,1375,0,11,0,0,4,3,13,32,29,3
SSC12843,Mungindi,1368,302,296,598,427,1229,0,68,0,9,34,28,76,258,242,16
SSC12850,Murrami,1369,130,102,232,166,1262,0,15,0,0,18,8,48,121,114,7
SSC12852,Murray Downs,1370,130,135,265,224,1666,0,34,6,0,17,22,35,138,135,3
SSC12854,Murrays Beach,1371,306,324,630,466,2070,0,29,39,13,111,64,106,292,278,14
SSC12858,Murringo,1372,188,172,360,304,1138,0,21,10,0,37,25,76,179,164,15
SSC12860,Murrumbateman,1373,1610,1608,3218,2440,2822,0,169,208,111,451,286,437,1804,1749,55
SSC12863,Murrumburrah,1374,54,50,104,92,1062,0,4,3,0,6,11,22,54,54,0
SSC12864,Murrurundi,1375,483,554,1037,863,824,0,137,17,7,46,73,176,402,372,30
SSC12866,Murwillumbah,1376,3282,3750,7032,5704,957,450,786,106,96,540,470,1300,2788,2584,204
SSC12867,Muscle Creek,1377,168,151,319,226,2410,0,24,3,4,16,24,77,178,174,4
SSC12868,Muswellbrook,1378,6183,5889,12072,9309,1331,380,1212,120,71,566,539,2431,5379,4860,519
SSC12870,Muttama,1379,66,62,128,104,1416,0,27,0,3,3,8,32,62,59,3
SSC12875,Mylestom,1380,165,178,343,303,974,0,24,8,6,27,25,74,147,140,7
SSC12876,Mylneford,1381,43,36,79,66,1062,0,9,0,0,11,4,20,32,29,3
SSC12877,Myocum,1382,461,525,986,816,1139,0,125,35,14,182,97,137,458,432,26
SSC12878,Myola,1383,54,57,111,107,816,0,30,3,0,8,5,23,24,24,0
SSC12879,Myrtle Creek,1384,42,45,87,76,1041,0,5,0,0,3,4,17,37,37,0
SSC12885,Nabiac,1385,646,606,1252,1015,972,0,101,4,10,46,67,284,509,462,47
SSC12887,Nambucca Heads,1386,2998,3327,6325,5479,735,350,878,43,67,325,368,1272,1864,1649,215
SSC12889,Nana Glen,1387,514,536,1050,851,1231,400,89,11,20,76,70,257,519,474,45
SSC12895,Narara,1388,3866,4062,7928,6367,1531,450,514,187,101,755,670,1668,4179,3926,253
SSC12896,Narellan,1389,1746,1867,3613,2916,1519,0,259,58,37,222,243,781,1857,1766,91
SSC12897,Narellan Vale,1390,3483,3715,7198,5519,1969,0,361,128,68,543,517,1426,4035,3840,195
SSC12898,Naremburn,1391,2811,3081,5892,4691,2627,1000,412,627,170,1537,490,401,3385,3266,119
SSC12900,Narooma,1392,1325,1281,2606,2301,777,0,331,51,35,207,187,533,882,828,54
SSC12901,Narrabarba,1393,9,5,14,12,850,0,0,0,0,0,0,5,4,4,0
SSC12902,Narrabeen,1394,3895,4311,8206,7162,1582,1050,1014,342,152,1276,859,1374,4157,4044,113
SSC12903,Narrabri,1395,3709,3897,7606,6018,1317,350,906,103,74,496,361,1337,3612,3405,207
SSC12906,Narrandera,1396,2140,2237,4377,3529,963,240,662,31,34,228,209,703,1769,1650,119
SSC12909,Narrawallee,1397,600,641,1241,1047,947,0,101,34,16,109,101,285,504,472,32
SSC12910,Narraweena,1398,3148,3459,6607,5352,1577,750,604,194,79,735,537,1070,3094,2993,101
SSC12911,Narromine,1399,2295,2400,4695,3644,1086,308,508,29,29,289,225,830,2023,1866,157
SSC12912,Narwee,1400,2724,2898,5622,4595,1308,585,508,291,50,754,421,565,2561,2335,226
SSC12913,Nashdale,1401,206,200,406,306,1713,0,32,17,8,48,33,70,208,201,7
SSC12917,Neath,1402,244,252,496,412,691,0,74,0,0,10,20,92,138,117,21
SSC12920,Nelligen,1403,163,176,339,297,1033,0,21,3,4,24,31,96,169,157,12
SSC12922,Nelson,1404,230,217,447,391,1767,0,29,10,4,41,32,104,240,237,3
SSC12923,Nelson Bay,1405,2886,2935,5821,4924,1141,0,523,139,81,508,521,1295,2588,2384,204
SSC12926,Nemingha,1406,353,316,669,548,1375,0,59,8,3,45,47,175,363,347,16
SSC12929,Nerong,1407,59,50,109,95,733,0,9,0,0,4,3,27,27,24,3
SSC12934,Neutral Bay,1408,4920,5566,10486,9183,2301,850,1069,1289,321,3107,947,739,6597,6357,240
SSC12936,Nevertire,1409,97,90,187,148,1458,0,23,4,0,13,7,32,99,93,6
SSC12938,New Berrima,1410,276,310,586,454,1164,0,61,4,4,17,33,143,290,278,12
SSC12939,New Brighton,1411,174,179,353,293,1160,0,50,22,10,48,42,46,154,143,11
SSC12941,New Italy,1412,98,81,179,156,1160,0,32,6,6,17,14,41,79,73,6
SSC12942,New Lambton,1413,4836,5211,10047,8054,1449,455,584,432,201,1491,818,1633,5118,4827,291
SSC12943,New Lambton Heights,1414,1232,1224,2456,1944,2295,0,122,202,58,494,219,317,1306,1241,65
SSC12948,Newbridge,1415,95,90,185,159,1031,0,26,10,6,19,9,39,90,83,7
SSC12949,Newcastle,1416,1450,1310,2760,2609,1849,0,389,285,76,655,225,361,1636,1550,86
SSC12950,Newcastle East,1417,518,486,1004,893,1523,0,86,106,18,234,80,112,538,507,31
SSC12951,Newcastle West,1418,337,279,616,590,1306,0,100,33,20,119,54,94,344,309,35
SSC12953,Newington,1419,2869,2935,5804,4382,2306,0,326,573,110,1346,433,351,3062,2929,133
SSC12956,Newport,1420,4567,4732,9299,7554,2066,875,525,458,177,1690,1023,1436,5106,4936,170
SSC12957,Newrybar,1421,225,216,441,373,1468,0,50,27,8,63,46,74,224,220,4
SSC12960,Newtown,1422,7523,7503,15026,13585,2080,750,1610,1823,460,4252,1069,1148,9805,9359,446
SSC12961,Niagara Park,1423,1374,1376,2750,2160,1482,450,174,48,35,261,209,561,1406,1316,90
SSC12965,Nimbin,1424,744,738,1482,1246,651,0,244,37,20,159,135,254,497,420,77
SSC12966,Nimmitabel,1425,164,153,317,265,786,0,37,4,0,27,25,56,124,118,6
SSC12972,Nooroo,1426,24,32,56,46,1458,0,8,0,0,0,5,8,26,23,3
SSC12973,Norah Head,1427,556,579,1135,962,1567,410,70,26,30,119,93,263,541,510,31
SSC12974,Noraville,1428,1411,1505,2916,2396,1194,0,260,32,30,177,207,661,1332,1244,88
SSC12975,Nords Wharf,1429,462,429,891,716,1485,0,51,22,10,90,84,204,449,425,24
SSC12976,Normanhurst,1430,2529,2756,5285,4218,2140,650,321,472,138,1010,410,503,2588,2469,119
SSC12977,North Albury,1431,2993,3066,6059,4896,959,0,733,72,76,372,348,1218,2626,2384,242
SSC12979,North Arm Cove,1432,223,218,441,387,1097,0,47,6,4,39,45,109,158,145,13
SSC12980,North Avoca,1433,1099,1100,2199,1774,2215,575,144,112,59,368,216,337,1206,1154,52
SSC12981,North Balgowlah,1434,1784,1875,3659,2548,3119,0,144,253,88,709,305,358,1835,1769,66
SSC12982,North Batemans Bay,1435,278,280,558,497,929,0,67,14,4,39,31,122,235,215,20
SSC12983,North Boambee Valley,1436,910,1096,2006,1667,1238,0,362,35,22,190,137,338,763,729,34
SSC12984,North Bondi,1437,4495,4672,9167,7246,2544,1250,879,721,195,2420,674,709,5140,4955,185
SSC12988,North Curl Curl,1438,2065,2047,4112,3083,2768,1055,272,225,76,745,317,516,2063,2002,61
SSC12989,North Dorrigo,1439,96,92,188,159,1093,0,15,8,3,7,5,32,92,82,10
SSC12990,North Epping,1440,2210,2317,4527,3627,2539,650,249,511,140,965,335,390,2357,2257,100
SSC12991,North Gosford,1441,1803,1890,3693,3009,1195,0,333,95,42,380,289,739,1821,1677,144
SSC12992,North Haven,1442,847,823,1670,1496,741,0,225,15,11,76,75,387,499,449,50
SSC12993,North Lambton,1443,1649,1655,3304,2750,1275,400,187,137,47,403,263,602,1664,1491,173
SSC12994,North Lismore,1444,415,355,770,646,883,0,100,11,14,63,49,148,326,279,47
SSC12995,North Macksville,1445,285,312,597,511,904,0,81,0,4,35,33,125,216,200,16
SSC12996,North Macquarie,1446,16,14,30,23,3249,0,0,0,0,3,3,4,18,18,0
SSC12997,North Manly,1447,1543,1548,3091,2343,2571,0,203,181,53,491,253,354,1638,1568,70
SSC12998,North Narooma,1448,301,318,619,535,1039,0,55,9,12,74,44,157,216,205,11
SSC12999,North Narrabeen,1449,2903,2948,5851,4529,2177,0,419,209,99,742,555,1054,3160,3066,94
SSC13000,North Nowra,1450,2824,2969,5793,4661,1159,428,538,98,93,455,484,1224,2516,2382,134
SSC13001,North Parramatta,1451,6571,6670,13241,10909,1524,500,1496,941,215,2290,1038,1320,6618,6116,502
SSC13002,North Richmond,1452,2344,2632,4976,4024,1426,0,325,81,45,382,396,1018,2397,2286,111
SSC13003,North Rocks,1453,3863,4100,7963,6329,2131,550,398,579,159,1456,730,971,3969,3801,168
SSC13004,North Rothbury,1454,440,460,900,636,1600,0,78,5,9,62,47,202,447,424,23
SSC13005,North Ryde,1455,5342,5510,10852,8915,2034,650,723,857,164,2065,798,1237,5457,5177,280
SSC13007,North St Marys,1456,1957,1969,3926,3074,1097,340,476,24,11,140,171,588,1545,1360,185
SSC13009,North Strathfield,1457,2374,2392,4766,4026,1969,720,486,458,69,1028,362,414,2716,2561,155
SSC13010,North Sydney,1458,3766,3945,7711,6893,2272,875,831,1095,203,2396,578,464,4838,4639,199
SSC13011,North Tamworth,1459,2445,2695,5140,4268,1154,0,639,108,75,494,338,866,2281,2162,119
SSC13012,North Tumbulgum,1460,139,121,260,213,1422,0,9,4,0,27,27,58,121,116,5
SSC13013,North Turramurra,1461,1876,2383,4259,3653,1933,0,578,350,103,846,386,380,1576,1517,59
SSC13014,North Wagga Wagga,1462,381,340,721,589,1379,0,95,3,4,43,46,129,384,358,26
SSC13015,North Wahroonga,1463,970,1030,2000,1594,2702,0,85,184,41,500,177,157,1006,963,43
SSC13016,North Willoughby,1464,1952,2225,4177,3242,2202,0,265,314,105,939,329,328,2058,1960,98
SSC13017,North Wollongong,1465,1380,1226,2606,2421,1294,0,254,190,50,420,191,340,1392,1183,209
SSC13020,North Yeoval,1466,40,37,77,60,724,0,3,0,0,4,0,13,33,33,0
SSC13022,Northbridge,1467,3061,3286,6347,4930,3344,1200,358,702,148,1621,463,337,3002,2888,114
SSC13023,Northmead,1468,5300,5914,11214,9095,1639,490,760,778,188,1983,927,1520,5714,5415,299
SSC13024,Northwood,1469,497,482,979,781,4152,0,88,128,28,285,62,31,453,432,21
SSC13028,Nowra,1470,4400,4789,9189,7499,808,380,1309,97,78,426,477,1715,3076,2706,370
SSC13029,Nowra Hill,1471,1467,631,2098,1880,1772,0,849,23,10,90,102,325,734,702,32
SSC13031,Nulkaba,1472,359,333,692,545,1875,0,60,7,4,60,49,162,380,370,10
SSC13042,Nunderi,1473,324,334,658,545,1510,0,53,12,8,80,57,136,318,308,10
SSC13043,Nundle,1474,260,237,497,412,695,0,70,0,3,34,30,75,184,167,17
SSC13049,Nyngan,1475,1070,1090,2160,1713,1078,0,252,14,11,134,89,348,963,911,52
SSC13051,Nyrang Creek,1476,9,11,20,18,1999,0,0,0,0,4,0,3,10,10,0
SSC13053,Oak Flats,1477,3149,3264,6413,5303,1274,470,505,75,63,360,509,1443,3027,2816,211
SSC13054,Oakdale,1478,949,897,1846,1440,1672,410,127,25,14,93,116,443,957,906,51
SSC13056,Oakhampton,1479,94,97,191,172,1062,0,32,10,9,23,9,31,55,52,3
SSC13058,Oakhurst,1480,3465,3495,6960,5405,1880,0,471,163,43,770,471,970,3622,3377,245
SSC13060,Oakville,1481,1008,955,1963,1608,2095,0,110,36,22,141,142,459,1053,1020,33
SSC13063,Oatlands,1482,2738,2917,5655,4580,1922,600,380,369,69,1084,475,607,2767,2628,139
SSC13064,Oatley,1483,5090,5395,10485,8495,2142,620,549,799,243,2082,840,1319,5394,5172,222
SSC13068,Oberon,1484,1621,1629,3250,2658,1188,330,397,33,23,158,165,628,1445,1338,107
SSC13070,Ocean Shores,1485,2446,2691,5137,4244,1096,590,530,141,106,636,478,951,2391,2201,190
SSC13073,Old Bar,1486,2068,2319,4387,3587,917,400,452,75,66,309,309,952,1653,1512,141
SSC13075,Old Erowal Bay,1487,504,538,1042,818,918,0,108,7,10,46,58,246,404,364,40
SSC13077,Old Guildford,1488,1340,1323,2663,1924,1286,0,281,39,10,152,155,296,934,842,92
SSC13078,Old Junee,1489,123,142,265,208,1444,0,16,4,3,31,14,53,134,131,3
SSC13081,Old Toongabbie,1490,1551,1580,3131,2482,1700,0,178,136,35,380,240,522,1620,1543,77
SSC13085,One Mile,1491,224,191,415,345,1292,0,35,10,5,44,23,103,179,167,12
SSC13089,Ootha,1492,47,35,82,60,1437,0,9,0,0,6,7,13,38,38,0
SSC13091,Oran Park,1493,2342,2424,4766,3443,2194,0,375,157,43,446,356,863,2487,2417,70
SSC13092,Orange,1494,18449,19651,38100,29977,1275,370,3447,916,540,3686,2492,6845,17797,16636,1161
SSC13094,Orangeville,1495,643,606,1249,954,2381,0,88,25,20,97,97,259,683,657,26
SSC13095,Orchard Hills,1496,1005,879,1884,1585,2072,0,166,43,18,188,107,345,1046,999,47
SSC13096,Orient Point,1497,321,289,610,532,862,0,91,4,5,28,40,142,191,171,20
SSC13101,Otford,1498,193,178,371,298,2428,0,13,37,7,64,35,59,214,211,3
SSC13103,Ourimbah,1499,1948,2005,3953,3124,1609,420,221,102,47,423,350,760,2124,2011,113
SSC13110,Oxley Park,1500,1493,1615,3108,2450,1332,360,330,69,25,199,159,514,1446,1316,130
SSC13111,Oxley Vale,1501,1740,2007,3747,2861,1208,0,387,48,39,265,193,709,1656,1528,128
SSC13112,Oyster Bay,1502,2685,2803,5488,4175,2594,690,225,284,131,875,501,803,2903,2818,85
SSC13113,Oyster Cove,1503,43,41,84,68,900,0,0,0,0,12,0,16,38,29,9
SSC13115,Paddington,1504,6114,6795,12909,11190,2509,1100,1402,1734,392,3924,858,760,7878,7617,261
SSC13120,Padstow,1505,6552,6758,13310,11027,1539,560,1137,522,145,1721,1013,1823,6528,6089,439
SSC13121,Padstow Heights,1506,1711,1831,3542,2958,1523,0,242,115,45,359,284,662,1703,1632,71
SSC13125,Pagewood,1507,1880,1925,3805,3083,1870,910,332,204,43,556,268,482,1829,1758,71
SSC13131,Pallamallawa,1508,230,213,443,356,1174,0,71,3,3,20,30,71,204,201,3
SSC13132,Palm Beach,1509,811,779,1590,1404,2111,1100,141,108,35,343,185,193,782,739,43
SSC13135,Palmers Channel,1510,60,60,120,97,1187,0,9,0,0,6,7,26,59,59,0
SSC13136,Palmers Island,1511,228,230,458,385,1057,0,51,5,3,29,17,124,215,199,16
SSC13140,Pambula,1512,451,524,975,791,843,0,131,9,13,55,78,205,384,359,25
SSC13141,Pambula Beach,1513,296,357,653,558,1260,0,65,17,25,95,54,97,295,289,6
SSC13144,Panania,1514,6035,6390,12425,9886,1642,600,888,387,113,1380,993,1901,6073,5732,341
SSC13151,Parkes,1515,5522,5882,11404,9014,1142,320,1319,105,96,666,557,2220,4943,4589,354
SSC13153,Parklea,1516,2239,1231,3470,2878,2392,495,1156,169,21,439,231,241,1364,1290,74
SSC13156,Parramatta,1517,13422,12381,25803,21612,1739,490,2990,3597,419,6164,1679,1447,14056,12700,1356
SSC13159,Paterson,1518,435,456,891,700,1581,0,62,11,4,86,82,197,451,430,21
SSC13160,Patonga,1519,109,94,203,196,833,0,18,3,5,29,16,43,67,63,4
SSC13162,Paxton,1520,460,485,945,717,1257,0,81,6,4,27,46,200,389,358,31
SSC13166,Peak Hill,1521,549,558,1107,930,753,0,141,6,3,60,50,194,418,364,54
SSC13168,Peakhurst,1522,5006,5537,10543,8579,1514,600,906,372,112,1232,808,1524,4817,4562,255
SSC13169,Peakhurst Heights,1523,1168,1170,2338,1929,1727,0,149,90,35,289,208,375,1130,1082,48
SSC13171,Pearl Beach,1524,249,292,541,477,1309,0,67,49,20,96,53,76,176,166,10
SSC13172,Peats Ridge,1525,181,192,373,297,1696,0,44,4,0,18,21,68,192,182,10
SSC13176,Pejar,1526,26,26,52,47,1562,0,10,0,0,6,3,8,22,22,0
SSC13177,Pelaw Main,1527,529,485,1014,824,989,0,66,3,4,30,41,257,428,392,36
SSC13178,Pelican,1528,433,446,879,767,1206,0,58,3,4,44,69,226,398,370,28
SSC13181,Pemulwuy,1529,2423,2587,5010,3666,2396,640,310,352,67,954,431,467,2696,2580,116
SSC13182,Pendle Hill,1530,3671,3577,7248,5868,1504,470,756,613,82,1036,457,618,3242,2971,271
SSC13183,Pennant Hills,1531,3571,3708,7279,5968,2222,650,378,795,198,1681,589,621,3878,3662,216
SSC13184,Penrith,1532,6471,6821,13292,11112,1142,395,1464,403,131,1112,893,2313,6295,5758,537
SSC13185,Penrose,1533,113,133,246,207,924,0,25,10,3,41,23,42,107,104,3
SSC13186,Penshurst,1534,6189,6599,12788,10685,1591,620,989,884,179,2262,1024,1438,6783,6343,440
SSC13189,Perthville,1535,299,329,628,494,1513,0,68,19,6,53,44,144,331,315,16
SSC13190,Petersham,1536,4018,4101,8119,6993,1966,720,884,803,241,1864,614,768,4868,4644,224
SSC13191,Pheasants Nest,1537,360,330,690,539,2042,0,61,8,9,36,43,149,358,347,11
SSC13192,Phegans Bay,1538,225,210,435,358,1680,0,28,21,12,61,42,72,238,224,14
SSC13193,Phillip Bay,1539,344,361,705,573,2139,0,62,34,6,72,42,126,351,335,16
SSC13198,Picketts Valley,1540,109,105,214,165,2687,0,5,9,0,32,9,41,104,104,0
SSC13199,Picnic Point,1541,3006,3150,6156,4834,2015,635,415,237,88,735,490,1070,3166,3041,125
SSC13200,Picton,1542,2361,2452,4813,3820,1909,430,363,139,61,450,390,999,2572,2469,103
SSC13204,Pillar Valley,1543,177,139,316,257,779,0,46,10,0,23,13,65,128,107,21
SSC13226,Pitt Town,1544,1520,1515,3035,2288,2316,650,171,50,31,233,276,679,1663,1626,37
SSC13229,Pleasure Point,1545,270,257,527,391,2607,0,18,29,4,61,56,95,300,295,5
SSC13230,Plumpton,1546,4475,4728,9203,7076,1880,420,559,259,61,1196,647,1252,4624,4273,351
SSC13231,Point Clare,1547,1774,1959,3733,3011,1315,425,279,106,53,433,355,676,1737,1629,108
SSC13232,Point Frederick,1548,904,1023,1927,1667,1193,0,241,86,26,297,173,297,916,853,63
SSC13233,Point Piper,1549,701,723,1424,1236,3644,0,166,153,32,386,102,51,691,671,20
SSC13236,Pokolbin,1550,497,458,955,835,2079,0,156,40,19,149,106,130,512,499,13
SSC13238,Polo Flat,1551,16,14,30,21,1187,0,0,0,0,3,0,7,14,14,0
SSC13244,Port Hacking,1552,522,566,1088,864,2908,0,44,42,23,203,110,184,586,572,14
SSC13245,Port Kembla,1553,2551,2464,5015,4179,1016,425,572,85,40,312,318,978,2043,1822,221
SSC13246,Port Macquarie,1554,21196,23633,44829,37388,1069,450,4455,940,619,4097,3609,8758,18568,17345,1223
SSC13250,Portland,1555,1238,1185,2423,2011,1023,0,355,18,19,88,117,498,924,832,92
SSC13252,Possum Creek,1556,140,142,282,252,1273,0,33,11,5,35,19,56,132,122,10
SSC13254,Pottery Estate,1557,67,69,136,103,683,0,22,0,8,7,3,23,51,45,6
SSC13256,Potts Point,1558,5757,3671,9428,9207,1842,0,3068,956,201,2059,687,783,5357,5137,220
SSC13257,Pottsville,1559,3206,3491,6697,5100,1281,583,525,128,98,637,524,1295,2838,2665,173
SSC13258,Prairiewood,1560,1596,1648,3244,2658,1344,445,350,39,20,270,221,435,1319,1209,110
SSC13259,Premer,1561,43,37,80,68,900,0,6,0,0,8,5,6,33,27,6
SSC13260,Prestons,1562,7536,7779,15315,11392,1987,525,1089,441,104,1624,1209,1980,7405,6945,460
SSC13261,Pretty Beach,1563,177,170,347,292,1569,0,24,17,10,60,25,47,150,146,4
SSC13264,Primbee,1564,832,810,1642,1378,1190,415,180,38,16,90,117,356,710,645,65
SSC13266,Prospect,1565,2350,2361,4711,3807,1796,0,392,145,32,511,375,753,2435,2321,114
SSC13267,Pucawan,1566,18,17,35,34,1437,0,0,0,0,4,3,9,14,14,0
SSC13268,Puddledock,1567,21,21,42,39,1708,0,3,3,0,7,7,9,30,30,0
SSC13270,Pullabooka,1568,21,29,50,31,1781,0,0,0,0,3,4,11,27,27,0
SSC13273,Punchbowl,1569,10360,9880,20240,15658,1146,520,2253,594,103,1740,1227,1954,7869,7052,817
SSC13275,Purfleet,1570,64,64,128,97,457,0,3,0,0,0,0,11,9,5,4
SSC13277,Putney,1571,1985,2117,4102,3306,2456,1095,241,267,57,795,358,516,2131,2047,84
SSC13278,Putta Bucca,1572,106,112,218,184,2187,0,27,5,0,23,21,37,113,110,3
SSC13279,Putty,1573,95,66,161,133,850,0,69,3,0,5,7,23,27,27,0
SSC13281,Pymble,1574,5188,5867,11055,8695,3090,1000,528,1460,303,2810,768,493,5636,5348,288
SSC13283,Pyree,1575,50,49,99,89,1125,0,11,0,7,12,8,20,55,55,0
SSC13284,Pyrmont,1576,6479,6332,12811,11626,2280,770,1502,1583,279,3659,1102,889,8207,7799,408
SSC13285,Quaama,1577,135,148,283,247,806,0,20,5,11,21,24,64,121,115,6
SSC13286,Quakers Hill,1578,13391,13686,27077,20830,1993,450,1458,1418,345,3816,2096,3794,14665,13749,916
SSC13289,Quandary,1579,20,22,42,34,1375,0,0,3,4,8,3,3,27,27,0
SSC13290,Quandialla,1580,97,96,193,157,900,0,31,3,0,4,10,33,75,72,3
SSC13291,Queanbeyan,1581,3073,3163,6236,5343,1405,470,670,285,135,765,448,1010,3367,3192,175
SSC13292,Queanbeyan East,1582,2026,1904,3930,3260,1328,0,306,212,67,493,320,651,2296,2170,126
SSC13293,Queanbeyan West,1583,1533,1604,3137,2499,1817,480,244,84,40,271,229,579,1721,1654,67
SSC13294,Queens Park,1584,1472,1600,3072,2408,2829,0,288,320,65,759,205,188,1596,1527,69
SSC13296,Queenscliff,1585,1662,1713,3375,2928,2348,0,293,301,82,922,320,367,2206,2152,54
SSC13300,Quipolly,1586,91,90,181,140,1350,0,19,0,0,17,14,41,95,91,4
SSC13301,Quirindi,1587,1669,1776,3445,2789,1052,270,397,27,19,190,177,632,1465,1355,110
SSC13302,Quorrobolong,1588,244,263,507,439,1899,0,59,12,5,44,42,116,281,267,14
SSC13303,Raby,1589,2888,3057,5945,4707,1796,420,359,110,43,424,438,1191,3257,3080,177
SSC13304,Raglan,1590,616,584,1200,908,1463,0,83,9,11,57,78,309,601,558,43
SSC13305,Rainbow Flat,1591,347,328,675,577,1267,0,43,11,12,53,49,172,306,279,27
SSC13306,Rainbow Reach,1592,44,42,86,76,959,0,13,0,0,4,6,18,43,40,3
SSC13308,Ramornie,1593,108,96,204,174,767,0,29,0,0,7,15,42,72,65,7
SSC13309,Ramsgate,1594,542,573,1115,916,1616,600,91,45,12,137,95,178,562,541,21
SSC13310,Ramsgate Beach,1595,758,901,1659,1409,1247,0,202,58,15,181,150,255,764,734,30
SSC13312,Randwick,1596,14303,15690,29993,25426,2169,950,3087,3175,729,7489,2233,2685,17233,16564,669
SSC13315,Rankin Park,1597,1211,1246,2457,1994,1709,0,141,115,59,365,231,455,1219,1162,57
SSC13316,Rankins Springs,1598,94,80,174,134,1125,0,17,3,0,15,10,21,94,91,3
SSC13318,Rappville,1599,90,73,163,138,725,0,22,0,0,7,3,27,42,34,8
SSC13319,Rathmines,1600,940,961,1901,1591,1287,425,105,41,25,172,168,478,870,820,50
SSC13322,Ravensworth,1601,3,4,7,12,0,0,0,0,0,0,0,0,3,3,0
SSC13325,Raworth,1602,871,918,1789,1322,1833,0,74,44,17,159,161,372,885,832,53
SSC13327,Raymond Terrace,1603,6247,6570,12817,10066,1102,360,1159,94,62,519,661,2643,5421,4886,535
SSC13328,Razorback,1604,560,523,1083,830,2242,0,72,30,11,106,105,190,586,567,19
SSC13334,Red Rock,1605,213,220,433,347,964,0,35,5,8,46,30,90,174,157,17
SSC13339,Redfern,1606,7180,6031,13211,12299,1821,800,1869,1376,341,3637,993,1046,7925,7492,433
SSC13340,Redhead,1607,1703,1809,3512,2866,1281,490,289,109,64,431,266,644,1597,1510,87
SSC13344,Reefton,1608,19,25,44,34,2083,0,0,0,0,3,0,4,18,18,0
SSC13345,Regents Park,1609,2470,2456,4926,3957,1203,478,471,165,31,532,346,507,2139,1940,199
SSC13346,Regentville,1610,415,390,805,648,1804,408,68,20,6,53,64,165,444,428,16
SSC13349,Rennie,1611,25,18,43,40,1375,0,4,0,0,0,3,3,26,26,0
SSC13352,Repton,1612,309,339,648,512,1208,0,32,19,14,97,55,134,295,275,20
SSC13353,Reserve Creek,1613,69,62,131,107,1062,0,8,3,3,7,10,19,70,64,6
SSC13355,Revesby,1614,6858,7314,14172,11549,1516,550,1206,471,132,1670,1024,1966,6731,6294,437
SSC13356,Revesby Heights,1615,793,883,1676,1261,2188,0,89,72,13,209,147,271,889,859,30
SSC13358,Rhodes,1616,5843,6064,11907,10610,1693,0,917,2149,175,3407,848,476,6557,5943,614
SSC13360,Richmond,1617,2604,2874,5478,4749,1146,420,685,151,72,440,405,1010,2598,2408,190
SSC13368,Riverstone,1618,3621,3625,7246,5705,1667,500,649,137,54,593,455,1309,3618,3390,228
SSC13370,Riverview,1619,1877,1476,3353,2555,3692,0,139,327,96,760,196,173,1575,1510,65
SSC13371,Riverwood,1620,5953,6142,12095,10181,1014,520,1345,549,103,1492,832,1243,5180,4686,494
SSC13374,Robertson,1621,920,939,1859,1500,1422,460,187,80,29,200,151,402,852,821,31
SSC13375,Robin Hill,1622,487,432,919,736,2262,0,48,38,26,135,72,198,509,493,16
SSC13379,Rockdale,1623,8051,7485,15536,13459,1635,610,1530,1290,167,3087,1275,1364,8858,8196,662
SSC13391,Rodd Point,1624,637,740,1377,1079,2298,850,59,93,35,279,100,146,734,711,23
SSC13394,Rookwood,1625,3,0,3,3,0,0,0,0,0,0,0,0,0,0,0
SSC13395,Rooty Hill,1626,7241,7461,14702,11757,1766,420,1149,445,93,1989,932,1935,7131,6610,521
SSC13397,Ropes Crossing,1627,2984,3189,6173,4370,2028,0,354,354,47,844,440,756,3078,2921,157
SSC13398,Rose Bay,1628,4674,5377,10051,8238,2272,1400,1002,809,194,2508,844,764,5298,5100,198
SSC13405,Rosebery,1629,5077,5035,10112,8769,1891,0,1037,817,139,1967,755,1047,5518,5232,286
SSC13407,Rosedale,1630,120,105,225,193,1192,0,30,16,5,38,16,38,91,87,4
SSC13408,Rosehill,1631,2025,1785,3810,3156,1573,0,486,435,39,770,291,302,2128,1949,179
SSC13409,Roselands,1632,5717,5859,11576,9059,1355,585,1080,345,72,1241,806,1437,5097,4713,384
SSC13410,Rosemeadow,1633,3772,4085,7857,6034,1470,390,625,100,53,433,463,1360,3691,3402,289
SSC13412,Roseville,1634,4888,5197,10085,7908,2832,1130,614,1246,263,2571,706,520,5042,4813,229
SSC13413,Roseville Chase,1635,809,803,1612,1256,3029,0,74,144,31,418,132,111,816,792,24
SSC13417,Rossglen,1636,21,35,56,47,1075,0,10,0,0,6,3,8,15,12,3
SSC13420,Rossmore,1637,1197,1088,2285,1837,1452,0,268,16,16,117,120,374,1043,988,55
SSC13429,Rouse Hill,1638,4012,3957,7969,5878,2401,600,369,363,92,1059,647,1152,4390,4193,197
SSC13434,Royalla,1639,504,479,983,761,3069,0,82,37,31,106,80,162,535,522,13
SSC13435,Rozelle,1640,4172,4553,8725,7218,2873,775,821,988,250,2237,718,684,5225,5059,166
SSC13439,Rukenvale,1641,14,15,29,32,725,0,6,0,3,3,0,3,14,11,3
SSC13441,Running Stream,1642,63,68,131,118,1025,0,20,3,0,10,12,24,64,60,4
SSC13443,Ruse,1643,2725,2857,5582,4474,1641,0,338,96,39,346,432,1124,2875,2726,149
SSC13444,Rushcutters Bay,1644,1287,1261,2548,2403,1708,0,428,293,83,806,190,191,1633,1565,68
SSC13447,Russell Lea,1645,2380,2621,5001,4021,2148,0,379,310,116,918,399,566,2592,2507,85
SSC13448,Russell Vale,1646,771,775,1546,1203,1452,550,99,35,21,129,115,336,721,692,29
SSC13449,Rutherford,1647,5719,6169,11888,9137,1202,0,1008,81,60,482,582,2558,5283,4767,516
SSC13452,Rydal,1648,108,110,218,175,1062,0,46,0,0,13,11,42,86,83,3
SSC13453,Rydalmere,1649,3284,3355,6639,5343,1553,495,449,368,78,981,536,832,3345,3095,250
SSC13454,Ryde,1650,12901,13599,26500,22058,1714,660,2238,2270,405,5044,2160,2825,13989,13169,820
SSC13456,Ryhope,1651,9,17,26,24,2125,0,0,0,0,0,0,7,17,17,0
SSC13457,Rylstone,1652,453,467,920,781,856,0,110,12,10,64,56,201,361,331,30
SSC13458,Sackville,1653,149,145,294,264,1786,0,66,0,0,22,18,75,151,146,5
SSC13461,Sadleir,1654,1562,1572,3134,2365,861,0,358,31,10,89,133,338,971,812,159
SSC13463,Salamander Bay,1655,2255,2560,4815,4049,1016,0,500,76,47,341,373,1097,1790,1663,127
SSC13467,Salt Ash,1656,565,563,1128,929,1289,0,121,9,0,54,61,299,523,489,34
SSC13470,San Remo,1657,2125,2229,4354,3392,1146,360,338,17,7,147,193,929,1921,1730,191
SSC13471,Sancrox,1658,288,287,575,468,1449,0,52,11,5,58,57,119,287,278,9
SSC13472,Sanctuary Point,1659,3514,3711,7225,5994,857,0,725,42,50,253,441,1571,2440,2202,238
SSC13479,Sandy Beach,1660,1141,1150,2291,1778,1215,0,180,25,28,199,172,478,1048,956,92
SSC13486,Sandy Hollow,1661,84,86,170,126,1199,0,20,0,4,4,3,27,70,70,0
SSC13487,Sandy Point,1662,303,285,588,489,2277,0,44,24,5,78,61,123,342,326,16
SSC13489,Sans Souci,1663,4885,5415,10300,8553,1536,650,1001,382,121,1306,866,1519,4947,4718,229
SSC13491,Sapphire Beach,1664,1009,1067,2076,1687,1544,0,176,64,41,302,201,391,1030,980,50
SSC13492,Saratoga,1665,1907,2031,3938,3115,1638,520,244,99,56,450,349,832,1984,1895,89
SSC13495,Saumarez Ponds,1666,211,224,435,342,1718,0,25,14,7,61,34,92,236,233,3
SSC13498,Sawtell,1667,1779,1901,3680,3063,1107,448,284,130,77,446,325,697,1684,1573,111
SSC13500,Scarborough,1668,158,150,308,239,2058,0,18,28,10,46,27,50,173,167,6
SSC13501,Scheyville,1669,3,9,12,10,0,0,0,0,0,0,0,0,4,4,0
SSC13502,Schofields,1670,2509,2473,4982,3758,2051,0,309,238,68,641,335,787,2676,2539,137
SSC13503,Scone,1671,2744,2880,5624,4453,1318,340,605,73,52,437,321,1065,2654,2538,116
SSC13505,Scotland Island,1672,298,282,580,456,1800,0,38,50,13,116,56,75,308,297,11
SSC13508,Scotts Head,1673,462,436,898,751,969,0,66,14,19,107,78,190,346,313,33
SSC13509,Seaforth,1674,3442,3699,7141,5328,3384,1200,371,531,163,1591,619,605,3586,3457,129
SSC13510,Seaham,1675,509,497,1006,789,1940,0,37,23,8,91,83,257,553,518,35
SSC13511,Seahampton,1676,139,159,298,227,1458,0,12,0,0,24,19,73,161,150,11
SSC13515,Seelands,1677,216,203,419,351,1228,0,51,9,4,18,30,100,196,184,12
SSC13516,Sefton,1678,2915,2891,5806,4535,1276,470,576,130,42,511,362,669,2373,2148,225
SSC13518,Seven Hills,1679,9750,9582,19332,15603,1551,410,1607,892,196,2325,1379,2665,9480,8802,678
SSC13523,Shalvey,1680,1663,1805,3468,2577,1167,0,369,16,12,82,126,464,1249,1124,125
SSC13524,Shanes Park,1681,210,198,408,338,1708,0,56,3,0,20,12,74,211,195,16
SSC13525,Shannon Brook,1682,89,90,179,144,1100,0,24,0,0,5,5,33,81,78,3
SSC13528,Shannons Flat,1683,51,32,83,69,1125,0,10,6,0,7,14,21,36,36,0
SSC13532,Shell Cove,1684,2788,2833,5621,4165,2155,0,260,165,81,569,483,1044,2894,2724,170
SSC13533,Shellharbour,1685,1773,1786,3559,2962,1395,505,307,56,42,306,262,754,1705,1620,85
SSC13534,Shellharbour City Centre,1686,83,160,243,230,762,0,44,5,3,12,16,46,52,52,0
SSC13535,Shelly Beach,1687,654,662,1316,1083,1504,0,112,22,25,112,116,287,584,560,24
SSC13539,Shoal Bay,1688,934,936,1870,1632,908,0,467,27,14,119,121,343,572,509,63
SSC13540,Shoalhaven Heads,1689,1510,1549,3059,2639,842,0,318,58,44,240,236,704,1128,1088,40
SSC13542,Shortland,1690,1987,1921,3908,3265,1038,380,254,107,25,320,215,790,1784,1628,156
SSC13544,Silverdale,1691,1906,1777,3683,2850,2220,515,237,54,23,247,229,864,2047,1968,79
SSC13547,Silverwater,1692,2758,1406,4164,3675,1536,0,2055,142,28,358,184,243,1200,1104,96
SSC13549,Singleton,1693,2480,2520,5000,4096,1250,400,420,68,36,314,254,1090,2364,2151,213
SSC13550,Singleton Heights,1694,2345,2348,4693,3606,1597,0,374,42,34,220,246,1095,2260,2114,146
SSC13554,Skennars Head,1695,596,566,1162,967,1364,590,86,31,18,148,104,209,558,533,25
SSC13555,Skillion Flat,1696,41,37,78,65,941,0,11,0,0,3,0,21,30,30,0
SSC13558,Smeaton Grange,1697,10,8,18,15,2374,0,0,0,0,0,4,4,17,12,5
SSC13559,Smithfield,1698,5932,6040,11972,9593,1173,450,1519,149,39,738,704,1610,4569,4147,422
SSC13563,Smiths Lake,1699,619,612,1231,978,982,0,90,19,9,86,97,295,458,412,46
SSC13569,Sofala,1700,76,55,131,114,575,0,23,0,0,7,3,24,38,35,3
SSC13570,Soldiers Point,1701,698,725,1423,1226,1112,0,148,43,15,129,112,337,608,569,39
SSC13571,Somersby,1702,567,496,1063,894,1659,0,114,29,7,102,95,214,535,510,25
SSC13573,South Albury,1703,732,643,1375,1178,878,0,155,40,26,141,95,259,736,666,70
SSC13577,South Bathurst,1704,738,850,1588,1292,1099,0,152,41,18,133,90,301,681,630,51
SSC13578,South Bowenfels,1705,554,610,1164,928,1358,0,99,13,17,97,77,251,509,496,13
SSC13579,South Coogee,1706,2579,2919,5498,4396,1517,0,502,419,123,973,402,499,2464,2318,146
SSC13580,South Durras,1707,173,171,344,292,1148,0,55,10,13,32,25,74,147,135,12
SSC13581,South Golden Beach,1708,347,464,811,633,1130,0,92,30,23,108,84,147,385,356,29
SSC13582,South Grafton,1709,2952,3115,6067,4874,801,0,677,38,33,238,267,1153,2113,1799,314
SSC13583,South Granville,1710,2776,2717,5493,4113,957,433,795,123,20,359,304,494,1722,1517,205
SSC13584,South Gundagai,1711,421,390,811,649,1073,0,95,3,0,33,30,156,377,355,22
SSC13585,South Gundurimba,1712,167,149,316,264,1288,0,27,3,3,26,19,67,177,174,3
SSC13587,South Hurstville,1713,2464,2674,5138,4217,1581,600,436,312,61,723,420,560,2484,2330,154
SSC13588,South Kempsey,1714,1122,1185,2307,1798,889,0,364,18,14,90,91,399,724,625,99
SSC13589,South Lismore,1715,989,888,1877,1529,912,0,172,11,15,115,79,373,838,748,90
SSC13591,South Maitland,1716,246,224,470,402,931,0,100,5,4,22,16,77,179,151,28
SSC13592,South Maroota,1717,285,272,557,433,2052,0,68,12,9,37,51,121,275,267,8
SSC13593,South Murwillumbah,1718,584,534,1118,927,1042,0,126,15,7,60,68,240,440,407,33
SSC13594,South Nowra,1719,926,1005,1931,1467,1330,0,206,24,25,98,123,429,837,790,47
SSC13595,South Pambula,1720,238,241,479,391,1120,0,50,4,4,30,26,100,231,223,8
SSC13596,South Penrith,1721,5779,6013,11792,9304,1573,420,796,234,104,852,787,2305,5839,5518,321
SSC13597,South Tamworth,1722,3195,3373,6568,5326,889,0,890,34,25,250,314,1244,2707,2452,255
SSC13598,South Turramurra,1723,1521,1560,3081,2352,2564,0,169,280,83,655,255,275,1526,1464,62
SSC13599,South Wentworthville,1724,3110,3093,6203,4874,1469,0,549,289,55,726,446,794,2912,2695,217
SSC13600,South West Rocks,1725,2245,2360,4605,3971,853,400,505,34,39,268,257,1034,1493,1375,118
SSC13601,South Windsor,1726,2854,3040,5894,4684,1283,0,526,66,44,285,308,1200,2849,2667,182
SSC13605,Speers Point,1727,1626,1689,3315,2784,1369,0,241,97,51,373,307,671,1629,1523,106
SSC13607,Spencer,1728,166,137,303,277,812,0,93,3,3,14,22,57,105,100,5
SSC13612,Spring Farm,1729,2141,2167,4308,3145,2145,0,207,119,36,408,397,861,2469,2405,64
SSC13615,Spring Hill,1730,257,240,497,365,1649,0,42,3,3,36,34,86,235,231,4
SSC13619,Spring Ridge,1731,136,108,244,204,1330,0,11,0,3,17,23,42,134,131,3
SSC13621,Springdale,1732,81,74,155,118,1062,0,21,0,0,10,4,19,54,51,3
SSC13622,Springdale Heights,1733,965,1065,2030,1616,948,0,207,6,16,107,115,415,833,752,81
SSC13623,Springfield,1734,1976,2132,4108,3201,1527,450,254,82,57,415,352,770,2081,1949,132
SSC13629,Springwood,1735,3938,4540,8478,7047,1550,450,578,490,230,1243,851,1448,4092,3923,169
SSC13631,St Andrews,1736,2892,2835,5727,4529,1643,420,378,101,63,424,389,1055,2950,2745,205
SSC13632,St Clair,1737,9894,10002,19896,15752,1859,430,1370,346,128,1460,1307,3774,10795,10245,550
SSC13636,St Georges Basin,1738,1397,1515,2912,2433,955,410,305,36,23,133,178,699,1100,1019,81
SSC13637,St Helens Park,1739,3214,3392,6606,4972,1651,0,419,81,46,382,427,1266,3364,3145,219
SSC13638,St Huberts Island,1740,519,541,1060,934,1414,0,122,35,11,90,103,234,480,466,14
SSC13640,St Ives Chase,1741,1552,1606,3158,2463,2938,0,157,302,89,694,263,247,1539,1487,52
SSC13641,St Johns Park,1742,2962,3161,6123,5161,1505,480,752,80,32,568,328,706,2605,2382,223
SSC13642,St Leonards,1743,2727,2769,5496,4976,2327,0,495,1008,152,1851,368,301,3761,3597,164
SSC13643,St Marys,1744,6049,6145,12194,9716,1190,360,1496,246,65,791,682,1911,5526,5005,521
SSC13644,St Peters,1745,1590,1550,3140,2761,2318,730,291,266,96,738,277,354,2109,2026,83
SSC13646,Stanbridge,1746,102,96,198,161,1053,0,36,3,0,8,4,28,88,81,7
SSC13647,Stanford Merthyr,1747,263,290,553,452,1091,0,55,0,5,17,24,133,242,219,23
SSC13649,Stanhope Gardens,1748,4490,4672,9162,6831,2291,0,475,632,123,1629,733,1004,4880,4617,263
SSC13650,Stanmore,1749,3939,4002,7941,6825,2179,820,780,850,218,2040,623,673,4832,4655,177
SSC13653,Stanwell Park,1750,730,686,1416,1149,2338,0,78,104,45,265,126,193,784,754,30
SSC13654,Stanwell Tops,1751,256,243,499,388,2360,0,29,20,13,60,49,104,261,252,9
SSC13660,Stockinbingal,1752,186,188,374,309,772,0,36,5,0,13,23,75,135,131,4
SSC13662,Stockton,1753,2079,2078,4157,3579,1286,440,753,102,47,352,274,860,1747,1627,120
SSC13664,Stokers Siding,1754,347,318,665,540,1196,0,88,21,11,81,57,113,295,270,25
SSC13667,Stony Chute,1755,87,80,167,150,754,0,27,6,7,21,16,31,62,51,11
SSC13672,Stratford,1756,84,68,152,120,833,0,15,0,0,8,11,28,58,53,5
SSC13675,Strathfield,1757,12931,12883,25814,22566,1892,700,2356,2575,360,6286,1805,1575,13967,13024,943
SSC13676,Strathfield South,1758,1743,1804,3547,2908,1809,603,260,225,61,626,285,383,1877,1749,128
SSC13677,Stroud,1759,433,501,934,747,1192,395,69,9,8,51,65,167,390,367,23
SSC13679,Stroud Road,1760,117,109,226,190,1292,0,17,0,0,9,13,56,107,100,7
SSC13680,Stuart Town,1761,121,112,233,196,1020,0,39,0,0,12,21,30,98,91,7
SSC13681,Stuarts Point,1762,389,377,766,662,715,0,94,7,7,33,38,169,250,214,36
SSC13682,Stubbo,1763,135,97,232,184,1109,0,33,0,0,16,15,54,95,92,3
SSC13684,Suffolk Park,1764,1782,1972,3754,3106,1514,0,433,163,82,651,316,590,1965,1849,116
SSC13687,Summer Hill,1765,3553,3751,7304,6185,1940,683,647,808,223,1775,555,625,4359,4179,180
SSC13690,Summerland Point,1766,1228,1266,2494,2047,1126,400,158,29,15,119,150,599,1065,963,102
SSC13691,Sun Valley,1767,111,120,231,184,2062,0,17,20,9,31,21,38,109,109,0
SSC13695,Sunshine Bay,1768,559,668,1227,1047,960,0,110,8,19,73,89,251,443,393,50
SSC13697,Surf Beach,1769,883,993,1876,1583,907,0,230,37,23,123,143,382,693,631,62
SSC13698,Surfside,1770,678,693,1371,1072,910,0,139,7,17,71,80,302,491,451,40
SSC13699,Surry Hills,1771,9431,6985,16416,15609,2144,895,2601,1962,383,4907,1360,1169,10673,10182,491
SSC13700,Sussex Inlet,1772,1801,1773,3574,3182,768,1005,387,26,21,155,192,872,1051,974,77
SSC13701,Sutherland,1773,5189,5628,10817,9042,1667,555,935,618,193,1731,994,1828,6179,5918,261
SSC13702,Sutton,1774,865,797,1662,1368,2371,0,314,75,38,174,117,243,791,761,30
SSC13703,Sutton Forest,1775,260,216,476,395,1480,0,45,23,8,67,26,87,231,225,6
SSC13705,Swan Bay,1776,113,108,221,177,1359,0,16,0,3,15,15,52,102,99,3
SSC13709,Swanhaven,1777,97,99,196,169,734,0,29,4,0,6,5,54,50,45,5
SSC13711,Swansea,1778,2476,2582,5058,4418,874,393,534,40,42,230,274,1173,1950,1768,182
SSC13712,Swansea Heads,1779,318,297,615,513,1634,0,41,15,15,68,45,159,296,273,23
SSC13714,Sydenham,1780,578,562,1140,1024,1861,710,125,79,19,223,111,127,697,654,43
SSC13715,Sydney,1781,8814,8437,17251,16462,1949,1025,2881,1920,209,4755,1865,825,10654,10021,633
SSC13716,Sydney Olympic Park,1782,900,834,1734,1567,1768,0,327,240,29,437,106,102,978,891,87
SSC13717,Sylvania,1783,4951,5532,10483,8571,1649,723,901,369,129,1286,926,1702,4836,4628,208
SSC13718,Sylvania Waters,1784,1588,1578,3166,2589,1973,0,265,102,27,415,270,477,1608,1527,81
SSC13723,Tabulam,1785,239,228,467,393,725,0,59,9,6,27,19,66,143,132,11
SSC13725,Tacoma South,1786,133,111,244,210,1687,0,8,5,0,14,21,57,130,127,3
SSC13727,Tahmoor,1787,2455,2611,5066,3970,1403,410,501,68,49,238,302,1102,2348,2206,142
SSC13730,Talbingo,1788,126,116,242,211,909,0,42,3,3,15,21,60,62,59,3
SSC13732,Tallimba,1789,99,80,179,141,1156,0,28,0,0,3,5,34,88,88,0
SSC13733,Tallong,1790,434,382,816,660,1176,0,68,17,3,60,71,186,355,335,20
SSC13741,Tamarama,1791,789,835,1624,1385,3348,1375,221,176,30,446,122,103,961,930,31
SSC13742,Tamban,1792,43,50,93,79,774,0,30,3,0,0,6,15,35,27,8
SSC13743,Tambar Springs,1793,107,83,190,159,749,0,41,0,0,19,18,19,85,79,6
SSC13745,Taminda,1794,35,21,56,47,624,0,5,0,0,3,3,13,31,28,3
SSC13746,Tamworth,1795,106,71,177,158,825,0,25,3,0,11,12,38,89,77,12
SSC13748,Tanilba Bay,1796,1536,1616,3152,2554,968,400,291,32,26,135,205,710,1153,1054,99
SSC13749,Tanja,1797,80,78,158,146,1062,0,19,9,5,33,10,34,73,70,3
SSC13754,Tantonan,1798,12,14,26,20,1916,0,0,0,0,3,3,3,18,18,0
SSC13758,Tarago,1799,223,205,428,342,1645,0,46,15,7,30,28,86,224,219,5
SSC13759,Taralga,1800,241,219,460,381,1050,0,71,7,3,27,21,83,210,198,12
SSC13760,Tarana,1801,90,82,172,134,1521,0,23,3,3,12,16,31,84,84,0
SSC13762,Tarbuck Bay,1802,96,92,188,148,792,0,10,0,0,14,12,49,77,71,6
SSC13763,Tarcutta,1803,233,207,440,376,1083,0,55,7,0,26,24,85,223,207,16
SSC13764,Taree,1804,7745,8447,16192,13271,808,340,1850,124,125,780,896,3083,5696,5021,675
SSC13765,Taree South,1805,153,166,319,274,767,0,37,5,0,19,26,71,119,103,16
SSC13766,Taren Point,1806,779,949,1728,1532,1391,873,250,50,17,223,141,258,639,609,30
SSC13769,Tarrawanna,1807,948,1125,2073,1765,1104,530,170,72,22,206,150,397,903,854,49
SSC13771,Tarro,1808,787,859,1646,1373,975,0,135,6,4,47,76,334,706,641,65
SSC13772,Tascott,1809,798,806,1604,1331,1580,0,110,70,34,202,143,297,818,767,51
SSC13774,Tathra,1810,842,836,1678,1449,1087,425,189,57,47,239,131,277,728,706,22
SSC13775,Tatton,1811,1272,1346,2618,1967,2118,0,124,86,46,336,175,428,1388,1331,57
SSC13777,Taylors Beach,1812,64,54,118,92,1145,0,9,0,0,10,14,29,53,50,3
SSC13779,Tea Gardens,1813,1409,1474,2883,2647,891,370,313,48,38,207,269,660,778,713,65
SSC13780,Telarah,1814,1147,1190,2337,1865,1017,0,182,16,11,112,110,501,1026,920,106
SSC13781,Telegraph Point,1815,319,290,609,510,1199,0,62,4,3,37,60,146,315,301,14
SSC13782,Telopea,1816,2668,2757,5425,4457,1202,0,485,390,74,879,466,597,2521,2303,218
SSC13784,Temora,1817,2305,2386,4691,3834,982,275,436,29,44,280,205,880,1987,1879,108
SSC13785,Tempe,1818,1760,1793,3553,2899,1912,678,285,218,73,596,252,385,1948,1858,90
SSC13787,Tenambit,1819,1418,1484,2902,2328,1118,0,229,31,26,200,205,565,1267,1147,120
SSC13790,Tennyson Point,1820,616,602,1218,997,2725,0,118,82,11,243,85,147,612,585,27
SSC13792,Tenterfield,1821,1914,2149,4063,3411,794,240,579,30,39,245,223,811,1570,1456,114
SSC13793,Teralba,1822,809,781,1590,1354,1133,505,207,17,13,75,110,374,701,631,70
SSC13795,Terara,1823,118,114,232,213,900,0,36,4,3,24,15,46,101,97,4
SSC13797,Termeil,1824,128,126,254,218,1078,0,17,4,0,23,15,70,128,123,5
SSC13802,Terranora,1825,1445,1476,2921,2290,1752,605,167,61,50,310,234,573,1493,1395,98
SSC13804,Terrey Hills,1826,1498,1534,3032,2429,2391,1098,223,142,63,431,285,470,1555,1501,54
SSC13805,Terrigal,1827,5550,5795,11345,9351,1679,550,752,422,210,1658,1041,1991,5816,5514,302
SSC13807,Teven,1828,162,126,288,235,1645,0,33,7,5,43,24,46,148,138,10
SSC13816,The Channon,1829,187,185,372,305,939,0,26,8,11,57,35,72,188,170,18
SSC13818,The Entrance,1830,1905,2101,4006,3439,846,395,557,48,39,237,232,725,1540,1357,183
SSC13819,The Entrance North,1831,726,752,1478,1249,1135,0,134,16,9,115,125,342,658,609,49
SSC13827,The Junction,1832,504,540,1044,910,1582,550,76,67,28,216,88,148,601,571,30
SSC13831,The Oaks,1833,1235,1288,2523,1960,1821,550,189,45,29,164,171,544,1338,1289,49
SSC13835,The Ponds,1834,5843,5894,11737,8296,2649,0,539,1013,175,2189,916,1071,6189,5918,271
SSC13837,The Risk,1835,33,35,68,51,1124,0,3,0,0,4,3,7,30,30,0
SSC13838,The Rock,1836,613,624,1237,999,1228,0,149,16,16,80,70,250,541,517,24
SSC13840,The Rocks,1837,429,346,775,732,3516,0,247,76,12,195,47,35,361,351,10
SSC13845,Theresa Park,1838,274,260,534,446,2103,0,48,15,3,49,48,118,278,278,0
SSC13847,Thirlmere,1839,1991,2051,4042,3238,1562,0,471,86,35,247,257,862,1897,1799,98
SSC13848,Thirroul,1840,3032,3054,6086,4835,1947,685,362,453,166,976,503,952,3021,2893,128
SSC13849,Thora,1841,163,167,330,261,924,0,36,4,10,35,30,57,146,133,13
SSC13850,Thornleigh,1842,4164,4302,8466,6665,2262,580,553,730,205,1716,668,826,4375,4201,174
SSC13851,Thornton,1843,3996,4068,8064,6212,1647,435,318,101,79,496,575,1831,4317,4073,244
SSC13852,Thrumster,1844,211,212,423,304,1885,0,25,14,3,38,50,82,222,219,3
SSC13856,Thurgoona,1845,4206,4449,8655,6592,1618,0,500,163,147,834,643,1795,4525,4303,222
SSC13863,Tighes Hill,1846,842,841,1683,1361,1372,460,148,80,35,279,109,250,848,793,55
SSC13864,Tilba Tilba,1847,48,45,93,83,900,0,10,7,0,10,5,22,45,42,3
SSC13870,Timbumburi,1848,70,73,143,122,1625,0,17,0,3,21,15,23,87,87,0
SSC13874,Tingha,1849,417,413,830,664,854,0,116,3,4,15,28,112,276,231,45
SSC13875,Tingira Heights,1850,1033,1113,2146,1676,1719,0,170,37,38,164,136,444,1110,1051,59
SSC13876,Tinonee,1851,526,562,1088,901,1134,0,118,13,9,80,76,245,482,451,31
SSC13878,Tintenbar,1852,422,402,824,652,1631,0,91,28,19,96,73,144,354,346,8
SSC13879,Tintinhull,1853,203,194,397,303,1359,0,26,3,6,37,19,95,179,175,4
SSC13883,Tirrannaville,1854,118,116,234,192,1575,0,30,6,4,28,17,44,126,126,0
SSC13886,Tocumwal,1855,1329,1356,2685,2241,888,278,320,16,24,145,153,545,966,928,38
SSC13887,Tolland,1856,1616,1744,3360,2647,941,0,309,40,27,217,183,624,1435,1288,147
SSC13889,Tomago,1857,183,99,282,255,784,0,66,5,0,11,5,60,114,101,13
SSC13890,Tomakin,1858,517,480,997,875,1018,510,157,12,20,74,73,212,363,346,17
SSC13894,Tomerong,1859,547,525,1072,853,1354,0,92,18,16,103,70,282,531,506,25
SSC13896,Tomingley,1860,171,134,305,249,1158,0,46,3,5,17,19,60,139,134,5
SSC13902,Tooleybuc,1861,139,143,282,237,1062,0,49,0,0,14,18,47,122,118,4
SSC13906,Tooma,1862,58,49,107,86,1499,0,14,0,3,8,8,17,71,71,0
SSC13907,Toongabbie,1863,7190,7147,14337,11423,1729,450,1085,995,183,2071,1034,1702,7171,6675,496
SSC13912,Toormina,1864,2904,3289,6193,5033,876,0,598,62,62,376,352,1280,2416,2147,269
SSC13915,Tootool,1865,41,30,71,43,1145,0,8,0,0,6,6,6,32,32,0
SSC13916,Toowoon Bay,1866,264,266,530,460,949,0,72,12,0,53,48,100,214,199,15
SSC13918,Toronto,1867,2688,2915,5603,4736,1018,380,625,114,44,413,317,1057,2112,1903,209
SSC13925,Toukley,1868,2239,2311,4550,3875,903,363,678,40,21,204,261,908,1598,1449,149
SSC13928,Townsend,1869,435,453,888,704,928,0,91,4,8,27,52,212,339,323,16
SSC13929,Towradgi,1870,1510,1617,3127,2573,1209,0,219,97,39,330,252,625,1470,1398,72
SSC13930,Towrang,1871,90,86,176,141,1274,0,21,3,3,9,11,38,73,69,4
SSC13932,Trangie,1872,612,576,1188,979,978,0,151,4,10,61,54,186,501,462,39
SSC13934,Tregear,1873,1915,1975,3890,2856,947,310,520,21,10,69,113,437,1225,1023,202
SSC13936,Trentham Cliffs,1874,42,30,72,57,1125,0,12,0,0,4,12,18,35,32,3
SSC13940,Trundle,1875,349,333,682,563,911,0,94,10,5,35,34,107,277,257,20
SSC13942,Trunkey Creek,1876,63,51,114,104,1036,0,15,0,0,4,5,26,51,51,0
SSC13944,Tubbul,1877,35,41,76,59,1375,0,13,0,0,8,0,9,43,43,0
SSC13946,Tucki Tucki,1878,92,76,168,132,1575,0,22,3,4,10,10,41,75,75,0
SSC13949,Tuena,1879,35,22,57,56,687,0,14,3,0,0,4,7,22,22,0
SSC13950,Tuggerah,1880,454,473,927,745,1276,430,51,14,8,75,75,190,470,443,27
SSC13951,Tuggerawong,1881,632,651,1283,1042,1204,0,103,20,12,64,85,292,610,558,52
SSC13954,Tullamore,1882,229,197,426,358,1009,0,65,0,0,34,24,67,206,200,6
SSC13956,Tullera,1883,139,140,279,226,1357,0,18,18,7,22,17,55,169,166,3
SSC13957,Tullibigeal,1884,125,106,231,182,1031,0,31,0,0,11,13,39,115,115,0
SSC13958,Tullimbar,1885,253,273,526,405,1875,0,32,10,8,41,50,137,265,257,8
SSC13961,Tumbarumba,1886,916,944,1860,1533,1102,270,220,9,19,85,91,345,823,781,42
SSC13962,Tumbi Umbi,1887,2507,2605,5112,4145,1417,465,406,72,51,418,391,1100,2366,2219,147
SSC13963,Tumblong,1888,106,95,201,151,1339,0,26,0,0,12,11,25,92,89,3
SSC13964,Tumbulgum,1889,190,223,413,329,1337,0,34,4,0,25,37,96,217,210,7
SSC13966,Tumut,1890,3040,3190,6230,5042,1073,310,833,52,42,380,338,1106,2624,2452,172
SSC13969,Tuncurry,1891,2944,3238,6182,5568,750,390,900,32,43,256,365,1335,1823,1641,182
SSC13971,Tuntable Creek,1892,96,94,190,157,818,0,15,7,3,28,24,32,93,84,9
SSC13973,Tura Beach,1893,1494,1668,3162,2732,1064,463,306,64,65,323,262,632,1134,1080,54
SSC13979,Tuross Head,1894,1094,1146,2240,2016,893,420,213,50,52,195,213,523,754,690,64
SSC13980,Turramurra,1895,5776,6146,11922,9501,2657,850,584,1312,329,2959,963,731,5881,5610,271
SSC13982,Turrella,1896,1283,1230,2513,2072,1789,0,197,184,32,441,204,239,1328,1220,108
SSC13983,Turvey Park,1897,1579,1745,3324,2629,1519,0,205,107,92,460,198,618,1779,1685,94
SSC13984,Tweed Heads,1898,3905,4272,8177,7329,928,530,1146,177,96,670,622,1521,3128,2867,261
SSC13985,Tweed Heads South,1899,3525,4094,7619,6577,798,525,880,59,52,397,481,1509,2752,2526,226
SSC13986,Tweed Heads West,1900,2945,3254,6199,5336,842,0,809,66,39,310,375,1287,2395,2167,228
SSC13993,Tyagarah,1901,73,78,151,134,1020,0,22,7,7,27,15,16,82,71,11
SSC13994,Tyalgum,1902,252,298,550,424,900,0,67,5,12,38,39,87,198,179,19
SSC14000,Uki,1903,355,342,697,581,1053,0,95,18,7,83,61,113,295,273,22
SSC14001,Ulamambri,1904,104,111,215,177,1147,0,34,5,3,17,16,30,97,93,4
SSC14003,Ulladulla,1905,3198,3421,6619,5567,813,400,721,59,67,320,377,1423,2367,2175,192
SSC14004,Ulmarra,1906,391,390,781,653,818,0,90,3,6,25,50,158,323,289,34
SSC14005,Ulong,1907,125,111,236,176,758,0,47,3,0,6,12,37,69,61,8
SSC14006,Ultimo,1908,4250,4592,8842,8472,1230,750,1260,901,93,2538,626,375,4232,3694,538
SSC14007,Umina Beach,1909,8022,8707,16729,13727,1160,0,1611,334,149,1157,1239,3380,7364,6805,559
SSC14008,Unanderra,1910,2570,2859,5429,4502,950,420,784,80,50,314,294,1007,2096,1913,183
SSC14011,Ungarie,1911,287,278,565,437,945,0,72,6,0,28,22,84,223,211,12
SSC14015,Upper Burringbar,1912,151,123,274,237,883,0,34,3,3,25,24,52,124,117,7
SSC14037,Upper Manilla,1913,62,61,123,107,1125,0,19,3,0,8,14,20,63,60,3
SSC14039,Upper Myall,1914,10,11,21,25,1187,0,0,0,0,0,3,8,19,19,0
SSC14048,Upper Wilsons Creek,1915,35,36,71,52,1042,0,13,0,0,8,8,13,19,19,0
SSC14051,Uralla,1916,1274,1469,2743,2241,957,0,281,57,38,198,182,548,1199,1128,71
SSC14052,Urana,1917,210,175,385,322,863,0,85,7,0,13,17,53,136,132,4
SSC14055,Uranquinty,1918,455,449,904,696,1426,0,82,10,9,64,45,224,465,447,18
SSC14057,Urbenville,1919,159,162,321,271,657,0,81,0,0,14,12,47,87,81,6
SSC14061,Urunga,1920,1479,1522,3001,2609,931,380,377,36,42,233,201,622,1177,1080,97
SSC14062,Utungun,1921,86,82,168,131,933,0,6,0,0,12,13,45,79,71,8
SSC14063,Vacy,1922,323,307,630,482,1760,0,43,8,3,48,55,161,337,322,15
SSC14065,Valentine,1923,2736,2782,5518,4506,1795,540,265,212,92,759,537,1099,2765,2610,155
SSC14067,Valla,1924,457,476,933,763,1245,0,99,15,14,81,75,217,433,404,29
SSC14068,Valla Beach,1925,612,704,1316,1103,951,0,105,40,19,177,103,253,511,480,31
SSC14069,Valley Heights,1926,626,586,1212,958,1756,0,71,58,35,156,118,199,609,582,27
SSC14070,Varroville,1927,58,57,115,98,1812,0,20,8,0,10,7,25,48,45,3
SSC14071,Vaucluse,1928,4421,4918,9339,7323,2741,1950,721,777,167,2212,676,593,4467,4276,191
SSC14074,Villawood,1929,3223,2810,6033,4818,781,0,1226,75,20,307,270,520,1709,1454,255
SSC14075,Vincentia,1930,1579,1714,3293,2797,1252,480,319,168,73,401,294,662,1395,1329,66
SSC14076,Vineyard,1931,577,587,1164,966,1197,0,159,25,13,64,65,213,507,491,16
SSC14078,Vittoria,1932,28,38,66,58,1791,0,4,3,0,14,8,9,35,35,0
SSC14079,Voyager Point,1933,846,817,1663,1292,2820,0,92,106,18,284,142,232,945,908,37
SSC14080,Wadalba,1934,1398,1430,2828,2083,1598,500,141,50,19,183,194,568,1393,1294,99
SSC14083,Wagga Wagga,1935,3406,3697,7103,6191,1195,350,718,324,114,1070,450,1256,3827,3589,238
SSC14084,Wagstaffe,1936,111,111,222,183,1531,0,16,23,3,56,12,30,95,92,3
SSC14085,Wahroonga,1937,8363,9003,17366,13940,2584,825,1284,1697,426,4003,1404,1218,8350,7981,369
SSC14086,Waitara,1938,2850,3093,5943,4756,1721,700,457,800,141,1499,436,386,3075,2868,207
SSC14089,Wakeley,1939,2321,2425,4746,3860,1404,400,513,68,18,396,314,553,2028,1870,158
SSC14090,Wakool,1940,164,140,304,251,871,0,31,0,0,13,21,50,137,132,5
SSC14094,Walcha Road,1941,31,26,57,50,1042,0,6,0,0,3,5,11,28,28,0
SSC14097,Walla Walla,1942,410,424,834,665,1096,0,83,10,8,43,36,153,388,357,31
SSC14098,Wallabadah,1943,223,198,421,353,966,0,43,0,0,23,40,84,194,174,20
SSC14099,Wallabi Point,1944,345,348,693,530,1581,0,25,12,10,77,66,162,333,316,17
SSC14101,Wallacia,1945,840,785,1625,1310,1729,0,151,27,11,102,92,359,834,801,33
SSC14102,Wallaga Lake,1946,279,271,550,498,768,0,77,15,15,54,45,123,176,168,8
SSC14103,Wallagoot,1947,242,277,519,417,1152,0,62,14,10,67,29,106,244,236,8
SSC14104,Wallalong,1948,520,515,1035,785,2031,0,64,21,11,84,87,230,557,527,30
SSC14109,Wallarah,1949,183,181,364,289,1562,0,42,3,0,15,27,64,162,152,10
SSC14111,Wallarobba,1950,81,90,171,137,1354,0,13,3,0,13,16,43,86,86,0
SSC14113,Wallendbeen,1951,131,132,263,219,1224,0,11,0,3,21,21,42,124,117,7
SSC14114,Wallerawang,1952,992,988,1980,1545,1135,0,251,12,13,73,89,418,808,747,61
SSC14118,Wallsend,1953,6022,6445,12467,10449,1120,420,1112,335,105,1116,852,2366,5638,5141,497
SSC14122,Wamberal,1954,3237,3310,6547,5085,1981,593,406,204,128,914,609,1144,3331,3204,127
SSC14123,Wamboin,1955,858,853,1711,1375,3012,0,152,126,62,299,141,208,906,880,26
SSC14124,Wambool,1956,16,14,30,30,2124,0,6,0,0,6,3,3,17,17,0
SSC14127,Wandandian,1957,160,170,330,267,1642,0,28,5,0,19,20,81,151,148,3
SSC14135,Wangi Wangi,1958,1369,1392,2761,2366,1174,400,212,83,47,244,276,630,1157,1069,88
SSC14140,Warabrook,1959,919,1054,1973,1723,1391,440,238,99,25,230,161,322,913,839,74
SSC14141,Waratah,1960,2126,2366,4492,3880,1116,420,698,149,70,542,297,781,2232,2036,196
SSC14142,Waratah West,1961,1517,1473,2990,2566,1119,0,287,86,41,339,194,531,1399,1248,151
SSC14144,Wardell,1962,445,387,832,671,975,0,154,13,3,37,50,152,295,262,33
SSC14147,Wards River,1963,89,90,179,150,683,0,19,3,0,11,13,25,70,60,10
SSC14148,Wareemba,1964,697,849,1546,1256,2043,0,127,80,35,254,120,197,794,767,27
SSC14149,Warialda,1965,791,799,1590,1309,919,0,200,5,11,71,74,262,618,579,39
SSC14150,Warialda Rail,1966,71,47,118,88,624,0,10,0,0,8,7,11,49,45,4
SSC14151,Warilla,1967,3161,3289,6450,5342,854,435,937,41,23,231,315,1176,2304,2065,239
SSC14153,Warners Bay,1968,3584,4031,7615,6257,1231,450,572,188,113,820,593,1510,3511,3297,214
SSC14154,Warnervale,1969,327,319,646,504,1652,535,25,5,6,29,43,164,338,321,17
SSC14157,Warragai Creek,1970,53,48,101,79,1312,0,12,0,0,7,3,17,38,35,3
SSC14158,Warragamba,1971,606,633,1239,996,1326,385,91,6,5,44,67,278,638,606,32
SSC14159,Warragoon,1972,62,54,116,92,1166,0,14,3,0,3,12,25,60,57,3
SSC14163,Warral,1973,195,171,366,318,1462,0,38,4,4,38,31,75,210,201,9
SSC14165,Warrawee,1974,1475,1518,2993,2436,3085,900,173,360,93,756,215,185,1504,1445,59
SSC14167,Warrawong,1975,2326,2428,4754,3826,762,380,626,46,19,164,200,704,1444,1238,206
SSC14170,Warrell Creek,1976,129,120,249,207,1260,0,12,0,0,12,18,69,115,109,6
SSC14171,Warren,1977,684,703,1387,1103,1059,255,169,7,11,85,68,203,625,567,58
SSC14173,Warriewood,1978,3599,3894,7493,5794,2160,950,623,315,120,1063,752,1102,3897,3758,139
SSC14174,Warrimoo,1979,1248,1201,2449,1941,2097,390,118,129,75,409,177,414,1373,1318,55
SSC14177,Warwick Farm,1980,3023,2865,5888,4807,980,410,1052,189,39,556,378,644,2268,1954,314
SSC14181,Watanobbi,1981,1855,2008,3863,3009,1220,0,326,35,16,208,230,763,1723,1547,176
SSC14182,Waterfall,1982,244,246,490,384,1837,0,21,17,7,61,41,104,264,251,13
SSC14183,Waterloo,1983,7650,6971,14621,13611,1503,760,2232,1379,264,3419,1081,1204,7791,7156,635
SSC14186,Waterview Heights,1984,641,686,1327,1083,1233,0,108,15,17,79,83,299,584,549,35
SSC14187,Watsons Bay,1985,418,426,844,702,2583,0,93,70,17,205,53,57,423,409,14
SSC14190,Wattamondara,1986,105,101,206,172,1062,0,18,3,0,16,14,56,98,93,5
SSC14191,Wattle Flat,1987,127,129,256,230,700,0,35,3,3,10,15,61,97,86,11
SSC14192,Wattle Grove,1988,4424,4535,8959,6820,2148,510,417,357,117,1186,776,1380,4979,4783,196
SSC14197,Wauchope,1989,2993,3319,6312,5038,920,390,701,36,40,280,333,1333,2332,2114,218
SSC14200,Waverley,1990,1945,2401,4346,3667,2138,0,656,369,88,1029,265,331,2141,2069,72
SSC14202,Waverton,1991,1427,1597,3024,2668,2392,920,243,480,84,972,247,170,1850,1791,59
SSC14209,Wedderburn,1992,328,304,632,505,2013,0,60,20,4,49,54,121,316,296,20
SSC14210,Wee Jasper,1993,61,42,103,94,949,0,11,3,3,17,8,10,47,47,0
SSC14211,Wee Waa,1994,1044,1036,2080,1598,1065,0,324,6,13,112,79,286,853,801,52
SSC14212,Weedallion,1995,10,5,15,10,850,0,0,0,0,0,3,3,7,7,0
SSC14214,Weetaliba,1996,27,21,48,47,725,0,12,0,0,3,0,11,11,11,0
SSC14215,Weethalle,1997,128,120,248,212,830,0,15,0,0,6,5,43,115,112,3
SSC14217,Weismantels,1998,13,10,23,23,724,0,9,0,0,0,3,10,5,5,0
SSC14219,Welby,1999,360,398,758,611,1085,0,94,14,9,38,46,154,328,317,11
SSC14221,Wellington,2000,1957,2122,4079,3286,781,280,606,23,22,140,174,695,1372,1184,188
SSC14223,Wells Crossing,2001,88,81,169,138,880,0,23,0,0,7,6,34,57,49,8
SSC14226,Wentworth Falls,2002,2884,3185,6069,5072,1239,448,513,387,178,932,575,966,2652,2508,144
SSC14227,Wentworth Point,2003,3369,3627,6996,6119,1877,0,857,849,138,1712,620,627,4363,4148,215
SSC14228,Wentworthville,2004,5830,5487,11317,9107,1693,470,829,1172,168,2064,769,1015,5739,5272,467
SSC14232,Werombi,2005,467,459,926,728,2133,0,82,18,7,59,61,237,501,486,15
SSC14233,Werri Beach,2006,288,275,563,461,1593,0,47,18,19,94,52,105,266,266,0
SSC14235,Werrington,2007,1967,2059,4026,3198,1228,378,319,146,41,317,255,673,1996,1816,180
SSC14236,Werrington County,2008,1815,1827,3642,2924,1799,0,220,52,18,185,227,788,1970,1889,81
SSC14237,Werrington Downs,2009,1633,1620,3253,2543,1898,0,165,59,21,207,211,708,1835,1743,92
SSC14238,Werris Creek,2010,809,763,1572,1306,786,0,238,9,7,41,49,236,524,466,58
SSC14239,West Albury,2011,1761,2096,3857,3251,1138,0,470,95,82,381,271,641,1679,1573,106
SSC14240,West Ballina,2012,1461,1560,3021,2606,943,0,379,36,18,184,216,596,1087,999,88
SSC14241,West Bathurst,2013,1784,1889,3673,2871,1061,0,324,78,47,285,219,750,1616,1496,120
SSC14244,West Gosford,2014,612,724,1336,1175,951,0,136,34,13,135,89,231,571,527,44
SSC14246,West Hoxton,2015,5044,4965,10009,7519,2171,530,686,211,67,1032,758,1413,5114,4796,318
SSC14247,West Kempsey,2016,2258,2665,4923,3856,761,0,821,27,20,166,157,859,1460,1288,172
SSC14248,West Nowra,2017,683,723,1406,1107,1192,0,123,11,11,72,101,313,692,629,63
SSC14249,West Pennant Hills,2018,8080,8293,16373,13348,2675,720,764,1509,366,3661,1392,1561,8723,8325,398
SSC14250,West Pymble,2019,2573,2725,5298,4025,2855,0,222,501,153,1228,397,374,2659,2540,119
SSC14251,West Ryde,2020,6536,6856,13392,11175,1677,600,962,1327,239,2973,1079,1331,7381,6898,483
SSC14252,West Tamworth,2021,2554,2645,5199,4113,861,0,705,37,33,216,210,835,2044,1801,243
SSC14253,West Wallsend,2022,1094,1148,2242,1790,1276,460,127,30,17,131,135,546,1055,975,80
SSC14254,West Wiangaree,2023,57,51,108,94,1199,0,11,0,0,11,10,24,56,53,3
SSC14255,West Wollongong,2024,2373,2453,4826,3880,1293,0,334,228,96,711,370,799,2365,2190,175
SSC14256,West Wyalong,2025,1513,1628,3141,2506,1148,0,478,23,27,195,126,529,1377,1331,46
SSC14257,Westbrook,2026,75,71,146,127,2166,0,13,3,0,6,10,46,82,82,0
SSC14259,Westdale,2027,1358,1400,2758,1955,1410,0,262,17,13,148,132,551,1320,1249,71
SSC14260,Westleigh,2028,2188,2275,4463,3575,2457,750,193,403,131,932,395,483,2326,2224,102
SSC14261,Westmead,2029,8224,8090,16314,12675,1866,500,1774,2561,246,3732,824,759,8034,7286,748
SSC14262,Weston,2030,1837,1856,3693,2863,1084,0,309,11,8,92,141,783,1482,1319,163
SSC14264,Wetherill Park,2031,3035,3089,6124,5030,1525,480,583,102,45,521,426,876,2717,2522,195
SSC14266,Whalan,2032,2877,3095,5972,4555,1008,335,756,50,15,212,219,741,2015,1747,268
SSC14267,Whale Beach,2033,120,136,256,221,2600,0,22,17,12,55,36,21,122,119,3
SSC14268,Wheeler Heights,2034,1432,1562,2994,2239,2367,0,187,81,45,401,253,493,1537,1494,43
SSC14276,Whitebridge,2035,1260,1346,2606,2108,1534,0,178,71,44,317,215,508,1304,1249,55
SSC14277,Whiteman Creek,2036,82,85,167,142,1125,0,28,3,0,16,4,24,55,52,3
SSC14279,Whittingham,2037,174,186,360,302,1625,0,34,3,4,20,20,84,180,171,9
SSC14280,Whitton,2038,258,234,492,398,1006,0,74,0,3,11,14,66,190,173,17
SSC14283,Wiangaree,2039,64,72,136,96,858,0,3,0,0,9,8,17,58,52,6
SSC14285,Wickham,2040,538,538,1076,976,1471,450,96,62,30,204,105,192,678,634,44
SSC14288,Wilberforce,2041,1523,1478,3001,2407,1867,0,211,48,36,209,237,666,1650,1580,70
SSC14293,Wiley Park,2042,5342,4789,10131,7667,1072,425,1054,636,88,1308,655,740,4111,3622,489
SSC14295,Willawarrin,2043,92,100,192,155,949,0,24,3,3,5,4,46,71,63,8
SSC14296,Willbriggie,2044,64,65,129,96,1531,0,14,0,3,3,0,27,61,58,3
SSC14299,Williamtown,2045,493,392,885,823,766,0,207,10,3,70,46,192,387,375,12
SSC14302,Willmot,2046,1165,1268,2433,1806,886,0,322,18,3,46,86,269,761,619,142
SSC14303,Willoughby,2047,3092,3448,6540,5008,2548,910,401,585,173,1456,502,510,3365,3237,128
SSC14304,Willoughby East,2048,919,906,1825,1319,3654,0,69,159,44,428,138,122,871,839,32
SSC14305,Willow Tree,2049,159,144,303,255,844,0,44,3,0,10,14,41,108,99,9
SSC14311,Wilton,2050,1569,1515,3084,2251,2449,0,121,72,50,285,279,674,1732,1695,37
SSC14312,Wimbledon,2051,56,53,109,93,1708,0,16,0,0,5,8,27,62,62,0
SSC14315,Windale,2052,1588,1773,3361,2617,689,355,413,7,4,53,90,490,915,741,174
SSC14316,Windang,2053,1356,1300,2656,2332,784,490,290,37,26,136,158,542,1009,941,68
SSC14317,Windella,2054,388,349,737,579,2432,0,27,26,17,60,63,165,411,391,20
SSC14321,Windermere Park,2055,339,356,695,541,1092,0,45,9,7,39,44,157,318,276,42
SSC14324,Windradyne,2056,1374,1563,2937,2285,1309,0,220,48,47,265,178,553,1393,1309,84
SSC14325,Windsor,2057,914,975,1889,1586,1422,420,169,52,15,168,121,364,931,868,63
SSC14326,Windsor Downs,2058,625,557,1182,1007,2458,0,96,37,12,99,87,265,680,668,12
SSC14330,Wingello,2059,278,291,569,466,1164,0,56,10,7,45,36,125,286,277,9
SSC14331,Wingen,2060,158,165,323,236,1416,0,66,4,0,19,14,63,132,121,11
SSC14332,Wingham,2061,2552,2821,5373,4432,912,320,531,39,46,269,274,1101,2068,1868,200
SSC14334,Winmalee,2062,2993,3205,6198,4884,1812,460,293,249,132,720,634,1152,3232,3105,127
SSC14335,Winston Hills,2063,5655,6019,11674,9152,2011,540,596,537,203,1781,1034,1715,5818,5577,241
SSC14339,Wirragulla,2064,20,7,27,30,1187,0,12,3,0,6,0,7,13,13,0
SSC14341,Wirrimbi,2065,41,43,84,68,1208,0,7,0,0,9,3,22,36,32,4
SSC14342,Wirrinya,2066,53,39,92,73,941,0,5,0,0,7,3,7,43,43,0
SSC14344,Wisemans Ferry,2067,103,113,216,191,954,0,30,5,0,21,12,51,108,104,4
SSC14349,Wolgan Valley,2068,39,30,69,59,2250,0,5,0,3,13,13,11,54,54,0
SSC14351,Wollar,2069,40,27,67,61,1062,0,24,0,0,7,3,8,22,19,3
SSC14353,Wolli Creek,2070,3239,3152,6391,5906,1868,0,684,919,103,1854,527,399,4143,3860,283
SSC14355,Wollombi,2071,87,101,188,167,792,0,34,9,10,26,16,31,74,68,6
SSC14357,Wollongbar,2072,1382,1448,2830,2256,1280,0,178,69,52,310,236,580,1416,1327,89
SSC14358,Wollongong,2073,9342,9100,18442,16784,1180,480,2389,1306,358,3165,1353,2535,8859,8051,808
SSC14359,Wollstonecraft,2074,3855,4470,8325,7220,2422,0,615,1237,296,2600,721,544,5333,5148,185
SSC14360,Wollumboola,2075,17,11,28,25,1062,0,0,0,0,3,3,7,16,16,0
SSC14361,Wollun,2076,31,36,67,43,1291,0,9,0,0,3,7,15,32,32,0
SSC14362,Wolumla,2077,350,356,706,575,1130,0,75,9,17,36,47,170,322,309,13
SSC14363,Wombarra,2078,426,443,869,712,2181,0,40,78,22,142,92,142,467,451,16
SSC14364,Wombat,2079,121,109,230,177,1218,0,20,0,9,23,14,37,104,97,7
SSC14366,Wombeyan Caves,2080,28,23,51,54,900,0,15,0,0,7,8,11,19,16,3
SSC14367,Womboota,2081,50,58,108,90,1024,0,16,3,0,9,10,12,53,50,3
SSC14371,Wondabyne,2082,3,0,3,1,0,0,0,0,0,0,0,4,0,0,0
SSC14372,Wondalga,2083,54,47,101,82,1625,0,7,0,0,14,9,13,57,54,3
SSC14373,Wongarbon,2084,385,384,769,560,1554,0,71,3,12,67,43,164,374,358,16
SSC14374,Wongawilli,2085,72,64,136,113,2055,0,5,6,0,8,13,37,82,79,3
SSC14376,Wongwibinda,2086,30,29,59,42,1375,0,4,0,0,11,3,10,36,36,0
SSC14377,Woodberry,2087,1434,1552,2986,2360,1032,0,270,8,4,77,104,552,1241,1044,197
SSC14378,Woodbine,2088,1415,1326,2741,2154,1570,380,260,63,27,198,201,482,1299,1213,86
SSC14379,Woodburn,2089,393,349,742,603,1005,0,103,8,4,28,27,153,301,273,28
SSC14381,Woodcroft,2090,3162,3282,6444,5241,2270,470,314,405,79,1481,486,658,3736,3498,238
SSC14382,Woodenbong,2091,192,193,385,324,861,0,49,0,3,20,26,67,157,143,14
SSC14383,Woodford,2092,961,974,1935,1584,1586,0,116,121,62,258,178,360,1003,950,53
SSC14384,Woodford Island,2093,116,124,240,199,1152,0,21,0,0,8,11,51,118,111,7
SSC14389,Woodlawn,2094,19,18,37,28,1374,0,0,0,0,3,3,8,18,15,3
SSC14390,Woodpark,2095,754,772,1526,1140,1577,0,117,32,13,132,87,214,673,619,54
SSC14391,Woodrising,2096,592,577,1169,925,1418,0,59,4,10,60,68,250,600,536,64
SSC14394,Woodstock,2097,364,329,693,601,872,0,75,3,0,50,48,127,278,252,26
SSC14400,Woolbrook,2098,87,97,184,142,900,0,22,4,0,10,7,19,70,67,3
SSC14402,Woolgoolga,2099,2623,2670,5293,4464,949,450,695,59,63,427,370,841,2143,2004,139
SSC14403,Wooli,2100,219,193,412,367,691,0,43,7,5,25,28,86,148,122,26
SSC14404,Woollahra,2101,3370,4036,7406,6314,2529,1250,874,865,179,2219,487,381,3950,3822,128
SSC14405,Woollamia,2102,279,280,559,483,1354,0,37,15,18,50,59,154,276,265,11
SSC14406,Woolloomooloo,2103,2275,1731,4006,3786,1794,0,657,411,80,1013,335,376,2328,2200,128
SSC14410,Woolooware,2104,1934,2022,3956,3178,1978,0,268,129,57,534,443,731,2179,2119,60
SSC14411,Wooloweyah,2105,200,211,411,356,1305,0,45,15,12,64,44,88,212,200,12
SSC14412,Woolwich,2106,383,434,817,699,3211,0,76,102,22,219,64,73,381,371,10
SSC14413,Woomargama,2107,82,79,161,135,939,0,10,4,0,18,13,42,78,75,3
SSC14414,Woombah,2108,426,418,844,752,816,0,112,4,0,51,60,183,274,247,27
SSC14415,Woongarrah,2109,2518,2704,5222,3844,1903,0,321,72,45,339,412,1008,2480,2358,122
SSC14416,Woonona,2110,5844,6341,12185,9776,1511,600,862,475,233,1360,1021,2235,5724,5442,282
SSC14417,Wootton,2111,112,85,197,173,833,0,23,3,3,7,22,59,81,73,8
SSC14420,Woronora,2112,1116,1082,2198,1788,2310,650,177,81,43,302,227,420,1219,1185,34
SSC14422,Woronora Heights,2113,1419,1433,2852,2339,2843,0,86,81,75,366,302,579,1803,1758,45
SSC14423,Worrigee,2114,2450,2618,5068,3801,1350,0,402,55,43,271,394,1118,2317,2178,139
SSC14425,Woy Woy,2115,5013,5627,10640,9038,947,395,1150,232,103,758,691,1965,4188,3821,367
SSC14426,Woy Woy Bay,2116,221,202,423,365,1864,0,27,12,10,59,49,88,229,215,14
SSC14431,Wyalong,2117,334,319,653,523,1149,0,82,0,4,24,37,121,320,308,12
SSC14434,Wyangala,2118,103,77,180,168,831,0,15,3,0,7,9,49,68,64,4
SSC14438,Wyee,2119,1177,1232,2409,1993,1125,0,194,23,14,111,150,515,1033,962,71
SSC14439,Wyee Point,2120,573,556,1129,896,1450,0,61,11,9,71,87,261,575,545,30
SSC14442,Wymah,2121,19,17,36,34,1624,0,7,3,0,3,3,9,17,17,0
SSC14445,Wyoming,2122,4808,5325,10133,8300,1194,450,1098,188,102,836,797,1859,4383,4055,328
SSC14446,Wyong,2123,2133,2195,4328,3625,918,395,512,50,39,250,278,806,1654,1482,172
SSC14447,Wyong Creek,2124,227,209,436,369,1589,0,48,16,9,49,33,91,231,231,0
SSC14448,Wyongah,2125,990,1030,2020,1582,1337,0,145,15,10,109,133,465,998,945,53
SSC14453,Yagoona,2126,8999,9012,18011,14029,1203,500,1807,406,96,1594,1100,2061,7165,6474,691
SSC14455,Yallah,2127,59,76,135,107,2833,0,10,0,4,6,12,34,70,70,0
SSC14458,Yamba,2128,2947,3124,6071,5308,873,480,703,97,78,493,440,1239,2064,1907,157
SSC14460,Yanco,2129,470,511,981,729,1018,0,79,3,0,26,24,159,302,283,19
SSC14461,Yanderra,2130,322,339,661,514,1831,0,49,8,3,34,34,164,347,339,8
SSC14462,Yanga,2131,24,14,38,29,1375,0,10,0,0,0,0,4,14,14,0
SSC14464,Yannergee,2132,9,12,21,24,1125,0,0,0,0,3,0,11,20,20,0
SSC14468,Yarra,2133,89,86,175,150,1624,0,22,4,0,18,19,32,100,97,3
SSC14469,Yarrabandai,2134,21,17,38,33,743,0,5,0,0,3,4,10,21,21,0
SSC14475,Yarramalong,2135,172,170,342,270,1981,0,23,14,6,31,39,74,197,186,11
SSC14477,Yarramundi,2136,432,403,835,657,2228,0,35,27,14,73,71,200,459,445,14
SSC14483,Yarravel,2137,568,547,1115,923,1133,0,95,6,11,56,68,251,475,431,44
SSC14485,Yarrawarrah,2138,1334,1398,2732,2190,2288,0,96,108,52,355,266,553,1558,1513,45
SSC14487,Yarrawonga Park,2139,191,190,381,318,1308,0,43,9,12,25,33,85,174,162,12
SSC14492,Yarrowyck,2140,64,66,130,113,833,0,19,3,0,12,18,16,63,60,3
SSC14493,Yass,2141,3118,3385,6503,5191,1470,340,695,142,100,612,419,1147,3071,2961,110
SSC14495,Yathella,2142,68,74,142,87,1791,0,4,0,3,20,15,25,73,73,0
SSC14496,Yattalunga,2143,269,276,545,430,1468,0,26,13,14,65,42,117,274,264,10
SSC14497,Yatte Yattah,2144,96,92,188,153,1428,0,21,3,4,11,15,44,91,86,5
SSC14502,Yellow Rock,2145,517,517,1034,823,2206,0,45,23,7,102,101,245,589,577,12
SSC14504,Yenda,2146,773,765,1538,1215,1266,0,165,7,6,85,70,291,772,738,34
SSC14506,Yennora,2147,804,816,1620,1336,749,0,288,17,7,81,68,151,458,404,54
SSC14507,Yeoval,2148,205,222,427,351,886,0,44,0,0,14,19,65,167,151,16
SSC14508,Yerong Creek,2149,165,191,356,258,1053,0,46,4,0,20,20,45,130,121,9
SSC14510,Yerrinbool,2150,568,598,1166,898,1507,0,69,15,15,51,89,275,592,570,22
SSC14511,Yerriyong,2151,13,13,26,22,1375,0,0,3,3,3,0,10,11,11,0
SSC14513,Yetholme,2152,131,108,239,188,1541,0,20,4,4,15,14,48,114,109,5
SSC14514,Yetman,2153,111,100,211,155,780,0,29,3,3,11,8,33,88,80,8
SSC14516,Yoogali,2154,621,606,1227,998,1674,0,192,8,7,56,45,236,636,621,15
SSC14518,Young,2155,4958,5338,10296,8093,966,280,1040,84,80,594,535,1898,4301,4033,268
SSC14519,Yowie Bay,2156,1497,1575,3072,2511,2488,800,183,122,49,490,292,510,1620,1566,54
SSC14524,Zetland,2157,5027,5051,10078,9248,1758,0,1110,1332,163,2489,732,677,5612,5186,426
